player,td24_rush,td24_rec,td24_total,career_rush,career_rec,career_total
a. a.abdullah,2,3,5,2,7,9
a. a.armah,0,0,0,0,1,1
a. a.auclair,0,0,0,0,1,1
a. a.barner,0,4,4,0,4,4
a. a.beck,0,0,0,1,2,3
a. a.brown,0,9,9,0,56,56
a. a.carr,0,0,0,0,1,1
a. a.collins,0,0,0,4,0,4
a. a.cooper,0,5,5,0,33,33
a. a.dillon,0,0,0,17,2,19
a. a.dulin,0,1,1,0,4,4
a. a.ekeler,4,0,4,37,16,53
a. a.erickson,0,0,0,0,1,1
a. a.estime,2,0,2,2,0,2
a. a.firkser,0,0,0,0,3,3
a. a.gibson,1,0,1,23,7,30
a. a.green,0,0,0,0,7,7
a. a.hooper,0,3,3,0,13,13
a. a.humphries,0,0,0,0,2,2
a. a.ingold,1,0,1,2,3,5
a. a.iosivas,0,6,6,0,10,10
a. a.isabella,0,0,0,0,2,2
a. a.janovich,0,0,0,1,0,1
a. a.jeffery,0,0,0,0,1,1
a. a.jones,5,2,7,26,16,42
a. a.kamara,6,2,8,34,15,49
a. a.lazard,0,6,6,0,25,25
a. a.mattison,4,1,5,14,7,21
a. a.miller,0,0,0,0,3,3
a. a.morris,0,0,0,1,1,2
a. a.o'connell,1,0,1,2,0,2
a. a.ogletree,0,1,1,0,3,3
a. a.okwuegbunam,0,0,0,0,4,4
a. a.perry,0,0,0,0,4,4
a. a.peterson,0,0,0,9,0,9
a. a.pierce,0,7,7,1,11,12
a. a.richardson,6,0,6,10,0,10
a. a.robinson,0,0,0,0,7,7
a. a.rodgers,0,0,0,6,1,7
a. a.schwartz,0,0,0,1,1,2
a. a.shaheen,0,0,0,0,3,3
a. a.sherman,0,0,0,0,1,1
a. a.smith,0,1,1,0,1,1
a. a.tate,0,0,0,0,1,1
a. a.thielen,0,5,5,0,39,39
a. a.thomas,0,0,0,0,1,1
a. a.trautman,0,2,2,0,9,9
a. a.walter,0,0,0,1,0,1
a. a.wesley,0,0,0,0,3,3
a. a.williams,0,0,0,3,0,3
a. aa.rodgers,0,0,0,2,0,2
a. al.robinson,0,0,0,0,3,3
a. brown,0,14,14,1,36,37
a.a.abdullah,2,3,5,2,7,9
a.a.armah,0,0,0,0,1,1
a.a.auclair,0,0,0,0,1,1
a.a.barner,0,4,4,0,4,4
a.a.beck,0,0,0,1,2,3
a.a.brown,0,9,9,0,56,56
a.a.carr,0,0,0,0,1,1
a.a.collins,0,0,0,4,0,4
a.a.cooper,0,5,5,0,33,33
a.a.dillon,0,0,0,17,2,19
a.a.dulin,0,1,1,0,4,4
a.a.ekeler,4,0,4,37,16,53
a.a.erickson,0,0,0,0,1,1
a.a.estime,2,0,2,2,0,2
a.a.firkser,0,0,0,0,3,3
a.a.gibson,1,0,1,23,7,30
a.a.green,0,0,0,0,7,7
a.a.hooper,0,3,3,0,13,13
a.a.humphries,0,0,0,0,2,2
a.a.ingold,1,0,1,2,3,5
a.a.iosivas,0,6,6,0,10,10
a.a.isabella,0,0,0,0,2,2
a.a.janovich,0,0,0,1,0,1
a.a.jeffery,0,0,0,0,1,1
a.a.jones,5,2,7,26,16,42
a.a.kamara,6,2,8,34,15,49
a.a.lazard,0,6,6,0,25,25
a.a.mattison,4,1,5,14,7,21
a.a.miller,0,0,0,0,3,3
a.a.morris,0,0,0,1,1,2
a.a.o'connell,1,0,1,2,0,2
a.a.ogletree,0,1,1,0,3,3
a.a.okwuegbunam,0,0,0,0,4,4
a.a.perry,0,0,0,0,4,4
a.a.peterson,0,0,0,9,0,9
a.a.pierce,0,7,7,1,11,12
a.a.richardson,6,0,6,10,0,10
a.a.robinson,0,0,0,0,7,7
a.a.rodgers,0,0,0,6,1,7
a.a.schwartz,0,0,0,1,1,2
a.a.shaheen,0,0,0,0,3,3
a.a.sherman,0,0,0,0,1,1
a.a.smith,0,1,1,0,1,1
a.a.tate,0,0,0,0,1,1
a.a.thielen,0,5,5,0,39,39
a.a.thomas,0,0,0,0,1,1
a.a.trautman,0,2,2,0,9,9
a.a.walter,0,0,0,1,0,1
a.a.wesley,0,0,0,0,3,3
a.a.williams,0,0,0,3,0,3
a.aa.rodgers,0,0,0,2,0,2
a.abdullah,2,3,5,2,7,9
a.al.robinson,0,0,0,0,3,3
a.armah,0,0,0,0,1,1
a.auclair,0,0,0,0,1,1
a.barner,0,4,4,0,4,4
a.beck,0,0,0,1,2,3
a.brown,0,9,9,0,56,56
a.carr,0,0,0,0,1,1
a.collins,0,0,0,4,0,4
a.cooper,0,5,5,0,33,33
a.dillon,0,0,0,17,2,19
a.dulin,0,1,1,0,4,4
a.ekeler,4,0,4,37,16,53
a.erickson,0,0,0,0,1,1
a.estime,2,0,2,2,0,2
a.firkser,0,0,0,0,3,3
a.gibson,1,0,1,23,7,30
a.green,0,0,0,0,7,7
a.hooper,0,3,3,0,13,13
a.humphries,0,0,0,0,2,2
a.ingold,1,0,1,2,3,5
a.iosivas,0,6,6,0,10,10
a.isabella,0,0,0,0,2,2
a.janovich,0,0,0,1,0,1
a.jeffery,0,0,0,0,1,1
a.jones,5,2,7,26,16,42
a.kamara,6,2,8,34,15,49
a.lazard,0,6,6,0,25,25
a.mattison,4,1,5,14,7,21
a.miller,0,0,0,0,3,3
a.morris,0,0,0,1,1,2
a.o'connell,1,0,1,2,0,2
a.ogletree,0,1,1,0,3,3
a.okwuegbunam,0,0,0,0,4,4
a.perry,0,0,0,0,4,4
a.peterson,0,0,0,9,0,9
a.pierce,0,7,7,1,11,12
a.richardson,6,0,6,10,0,10
a.robinson,0,0,0,0,7,7
a.rodgers,0,0,0,6,1,7
a.schwartz,0,0,0,1,1,2
a.shaheen,0,0,0,0,3,3
a.sherman,0,0,0,0,1,1
a.smith,0,1,1,0,1,1
a.st. brown,0,14,14,1,36,37
a.tate,0,0,0,0,1,1
a.thielen,0,5,5,0,39,39
a.thomas,0,0,0,0,1,1
a.trautman,0,2,2,0,9,9
a.walter,0,0,0,1,0,1
a.wesley,0,0,0,0,3,3
a.williams,0,0,0,3,0,3
aa.rodgers,0,0,0,2,0,2
al.robinson,0,0,0,0,3,3
b. b.aiyuk,0,0,0,2,26,28
b. b.allen,2,1,3,2,1,3
b. b.bell,0,0,0,0,2,2
b. b.berrios,0,0,0,4,6,10
b. b.bolden,0,0,0,2,3,5
b. b.bowers,0,5,5,0,5,5
b. b.cooks,0,3,3,0,26,26
b. b.edwards,0,0,0,0,4,4
b. b.hall,5,3,8,5,3,8
b. b.hill,0,0,0,1,0,1
b. b.irving,8,1,9,8,1,9
b. b.jarwin,0,0,0,0,2,2
b. b.johnson,0,0,0,0,5,5
b. b.jordan,0,0,0,0,6,6
b. b.mayfield,3,0,3,7,0,7
b. b.means,0,1,1,0,1,1
b. b.melton,0,0,0,0,2,2
b. b.nix,4,1,5,4,1,5
b. b.perriman,0,0,0,0,5,5
b. b.powell,0,0,0,0,3,3
b. b.pringle,0,0,0,0,11,11
b. b.purdy,5,0,5,9,0,9
b. b.robinson,24,1,25,35,10,45
b. b.roethlisberger,0,0,0,1,0,1
b. b.scott,0,0,0,14,1,15
b. b.sims,0,0,0,0,1,1
b. b.sinnott,0,1,1,0,1,1
b. b.skowronek,0,0,0,1,1,2
b. b.snell,0,0,0,5,0,5
b. b.strange,0,2,2,0,3,3
b. b.thomas,0,10,10,0,10,10
b. b.whiteheart,0,1,1,0,1,1
b. b.wright,0,2,2,0,9,9
b. b.young,6,0,6,6,0,6
b. b.zappe,0,0,0,1,0,1
b. b.zylstra,0,0,0,0,1,1
b. br.hall,0,0,0,4,1,5
b. bre.hall,0,0,0,5,4,9
b.aiyuk,0,0,0,2,26,28
b.allen,2,1,3,2,1,3
b.b.aiyuk,0,0,0,2,26,28
b.b.allen,2,1,3,2,1,3
b.b.bell,0,0,0,0,2,2
b.b.berrios,0,0,0,4,6,10
b.b.bolden,0,0,0,2,3,5
b.b.bowers,0,5,5,0,5,5
b.b.cooks,0,3,3,0,26,26
b.b.edwards,0,0,0,0,4,4
b.b.hall,5,3,8,5,3,8
b.b.hill,0,0,0,1,0,1
b.b.irving,8,1,9,8,1,9
b.b.jarwin,0,0,0,0,2,2
b.b.johnson,0,0,0,0,5,5
b.b.jordan,0,0,0,0,6,6
b.b.mayfield,3,0,3,7,0,7
b.b.means,0,1,1,0,1,1
b.b.melton,0,0,0,0,2,2
b.b.nix,4,1,5,4,1,5
b.b.perriman,0,0,0,0,5,5
b.b.powell,0,0,0,0,3,3
b.b.pringle,0,0,0,0,11,11
b.b.purdy,5,0,5,9,0,9
b.b.robinson,24,1,25,35,10,45
b.b.roethlisberger,0,0,0,1,0,1
b.b.scott,0,0,0,14,1,15
b.b.sims,0,0,0,0,1,1
b.b.sinnott,0,1,1,0,1,1
b.b.skowronek,0,0,0,1,1,2
b.b.snell,0,0,0,5,0,5
b.b.strange,0,2,2,0,3,3
b.b.thomas,0,10,10,0,10,10
b.b.whiteheart,0,1,1,0,1,1
b.b.wright,0,2,2,0,9,9
b.b.young,6,0,6,6,0,6
b.b.zappe,0,0,0,1,0,1
b.b.zylstra,0,0,0,0,1,1
b.bell,0,0,0,0,2,2
b.berrios,0,0,0,4,6,10
b.bolden,0,0,0,2,3,5
b.bowers,0,5,5,0,5,5
b.br.hall,0,0,0,4,1,5
b.bre.hall,0,0,0,5,4,9
b.cooks,0,3,3,0,26,26
b.edwards,0,0,0,0,4,4
b.hall,5,3,8,5,3,8
b.hill,0,0,0,1,0,1
b.irving,8,1,9,8,1,9
b.jarwin,0,0,0,0,2,2
b.johnson,0,0,0,0,5,5
b.jordan,0,0,0,0,6,6
b.mayfield,3,0,3,7,0,7
b.means,0,1,1,0,1,1
b.melton,0,0,0,0,2,2
b.nix,4,1,5,4,1,5
b.perriman,0,0,0,0,5,5
b.powell,0,0,0,0,3,3
b.pringle,0,0,0,0,11,11
b.purdy,5,0,5,9,0,9
b.robinson,24,1,25,35,10,45
b.roethlisberger,0,0,0,1,0,1
b.scott,0,0,0,14,1,15
b.sims,0,0,0,0,1,1
b.sinnott,0,1,1,0,1,1
b.skowronek,0,0,0,1,1,2
b.snell,0,0,0,5,0,5
b.strange,0,2,2,0,3,3
b.thomas,0,10,10,0,10,10
b.whiteheart,0,1,1,0,1,1
b.wright,0,2,2,0,9,9
b.young,6,0,6,6,0,6
b.zappe,0,0,0,1,0,1
b.zylstra,0,0,0,0,1,1
br.hall,0,0,0,4,1,5
bre.hall,0,0,0,5,4,9
c. c.akers,2,3,5,15,4,19
c. c.austin,0,4,4,1,6,7
c. c.batson,0,0,0,0,2,2
c. c.beasley,0,0,0,0,6,6
c. c.beebe,0,0,0,0,2,2
c. c.brate,0,0,0,0,8,8
c. c.brooks,1,0,1,1,0,1
c. c.brown,7,4,11,7,5,12
c. c.carson,0,0,0,8,4,12
c. c.claypool,0,0,0,2,15,17
c. c.clement,0,0,0,2,1,3
c. c.conley,0,0,0,0,4,4
c. c.davis,0,0,0,0,11,11
c. c.edmonds,0,0,0,5,5,10
c. c.edwards-helaire,0,0,0,13,7,20
c. c.evans,0,0,0,0,3,3
c. c.godwin,0,5,5,2,24,26
c. c.grayson,0,0,0,0,2,2
c. c.ham,1,0,1,3,1,4
c. c.hansen,0,0,0,0,1,1
c. c.henne,0,0,0,1,0,1
c. c.herndon,0,0,0,0,4,4
c. c.hogan,0,0,0,0,1,1
c. c.hubbard,10,1,11,22,2,24
c. c.huntley,0,0,0,1,0,1
c. c.hyde,0,0,0,5,0,5
c. c.johnson,0,0,0,0,2,2
c. c.kirk,0,1,1,0,25,25
c. c.kmet,0,4,4,0,19,19
c. c.kolar,0,1,1,0,2,2
c. c.kupp,0,6,6,1,42,43
c. c.lamb,0,6,6,3,39,42
c. c.manhertz,0,1,1,0,2,2
c. c.mccaffrey,0,0,0,34,16,50
c. c.mcdermott,0,0,0,0,1,1
c. c.moore,0,0,0,0,4,4
c. c.myarick,0,0,0,0,2,2
c. c.newton,0,0,0,17,1,18
c. c.okonkwo,0,2,2,0,6,6
c. c.olave,0,1,1,0,10,10
c. c.otton,0,4,4,0,11,11
c. c.parkinson,0,2,2,0,6,6
c. c.patterson,0,1,1,15,7,22
c. c.prosise,0,0,0,0,1,1
c. c.reynolds,0,0,0,2,0,2
c. c.ridley,1,4,5,1,23,24
c. c.rodriguez,2,0,2,4,0,4
c. c.rogers,0,0,0,0,1,1
c. c.samuel,0,3,3,4,14,18
c. c.sims,0,0,0,0,3,3
c. c.stover,0,1,1,0,1,1
c. c.stroud,0,0,0,3,0,3
c. c.sutton,0,8,8,0,22,22
c. c.thompson,0,0,0,0,2,2
c. c.tillman,0,3,3,0,3,3
c. c.tune,0,0,0,1,0,1
c. c.uzomah,0,0,0,0,10,10
c. c.watson,0,2,2,2,14,16
c. c.wentz,0,0,0,8,0,8
c. c.wilkins,0,0,0,0,1,1
c. c.wilson,0,1,1,0,12,12
c. co.heyward,0,1,1,0,2,2
c.akers,2,3,5,15,4,19
c.austin,0,4,4,1,6,7
c.batson,0,0,0,0,2,2
c.beasley,0,0,0,0,6,6
c.beebe,0,0,0,0,2,2
c.brate,0,0,0,0,8,8
c.brooks,1,0,1,1,0,1
c.brown,7,4,11,7,5,12
c.c.akers,2,3,5,15,4,19
c.c.austin,0,4,4,1,6,7
c.c.batson,0,0,0,0,2,2
c.c.beasley,0,0,0,0,6,6
c.c.beebe,0,0,0,0,2,2
c.c.brate,0,0,0,0,8,8
c.c.brooks,1,0,1,1,0,1
c.c.brown,7,4,11,7,5,12
c.c.carson,0,0,0,8,4,12
c.c.claypool,0,0,0,2,15,17
c.c.clement,0,0,0,2,1,3
c.c.conley,0,0,0,0,4,4
c.c.davis,0,0,0,0,11,11
c.c.edmonds,0,0,0,5,5,10
c.c.edwards-helaire,0,0,0,13,7,20
c.c.evans,0,0,0,0,3,3
c.c.godwin,0,5,5,2,24,26
c.c.grayson,0,0,0,0,2,2
c.c.ham,1,0,1,3,1,4
c.c.hansen,0,0,0,0,1,1
c.c.henne,0,0,0,1,0,1
c.c.herndon,0,0,0,0,4,4
c.c.hogan,0,0,0,0,1,1
c.c.hubbard,10,1,11,22,2,24
c.c.huntley,0,0,0,1,0,1
c.c.hyde,0,0,0,5,0,5
c.c.johnson,0,0,0,0,2,2
c.c.kirk,0,1,1,0,25,25
c.c.kmet,0,4,4,0,19,19
c.c.kolar,0,1,1,0,2,2
c.c.kupp,0,6,6,1,42,43
c.c.lamb,0,6,6,3,39,42
c.c.manhertz,0,1,1,0,2,2
c.c.mccaffrey,0,0,0,34,16,50
c.c.mcdermott,0,0,0,0,1,1
c.c.moore,0,0,0,0,4,4
c.c.myarick,0,0,0,0,2,2
c.c.newton,0,0,0,17,1,18
c.c.okonkwo,0,2,2,0,6,6
c.c.olave,0,1,1,0,10,10
c.c.otton,0,4,4,0,11,11
c.c.parkinson,0,2,2,0,6,6
c.c.patterson,0,1,1,15,7,22
c.c.prosise,0,0,0,0,1,1
c.c.reynolds,0,0,0,2,0,2
c.c.ridley,1,4,5,1,23,24
c.c.rodriguez,2,0,2,4,0,4
c.c.rogers,0,0,0,0,1,1
c.c.samuel,0,3,3,4,14,18
c.c.sims,0,0,0,0,3,3
c.c.stover,0,1,1,0,1,1
c.c.stroud,0,0,0,3,0,3
c.c.sutton,0,8,8,0,22,22
c.c.thompson,0,0,0,0,2,2
c.c.tillman,0,3,3,0,3,3
c.c.tune,0,0,0,1,0,1
c.c.uzomah,0,0,0,0,10,10
c.c.watson,0,2,2,2,14,16
c.c.wentz,0,0,0,8,0,8
c.c.wilkins,0,0,0,0,1,1
c.c.wilson,0,1,1,0,12,12
c.carson,0,0,0,8,4,12
c.claypool,0,0,0,2,15,17
c.clement,0,0,0,2,1,3
c.co.heyward,0,1,1,0,2,2
c.conley,0,0,0,0,4,4
c.davis,0,0,0,0,11,11
c.edmonds,0,0,0,5,5,10
c.edwards-helaire,0,0,0,13,7,20
c.evans,0,0,0,0,3,3
c.godwin,0,5,5,2,24,26
c.grayson,0,0,0,0,2,2
c.ham,1,0,1,3,1,4
c.hansen,0,0,0,0,1,1
c.henne,0,0,0,1,0,1
c.herndon,0,0,0,0,4,4
c.hogan,0,0,0,0,1,1
c.hubbard,10,1,11,22,2,24
c.huntley,0,0,0,1,0,1
c.hyde,0,0,0,5,0,5
c.johnson,0,0,0,0,2,2
c.kirk,0,1,1,0,25,25
c.kmet,0,4,4,0,19,19
c.kolar,0,1,1,0,2,2
c.kupp,0,6,6,1,42,43
c.lamb,0,6,6,3,39,42
c.manhertz,0,1,1,0,2,2
c.mccaffrey,0,0,0,34,16,50
c.mcdermott,0,0,0,0,1,1
c.moore,0,0,0,0,4,4
c.myarick,0,0,0,0,2,2
c.newton,0,0,0,17,1,18
c.okonkwo,0,2,2,0,6,6
c.olave,0,1,1,0,10,10
c.otton,0,4,4,0,11,11
c.parkinson,0,2,2,0,6,6
c.patterson,0,1,1,15,7,22
c.prosise,0,0,0,0,1,1
c.reynolds,0,0,0,2,0,2
c.ridley,1,4,5,1,23,24
c.rodriguez,2,0,2,4,0,4
c.rogers,0,0,0,0,1,1
c.samuel,0,3,3,4,14,18
c.sims,0,0,0,0,3,3
c.stover,0,1,1,0,1,1
c.stroud,0,0,0,3,0,3
c.sutton,0,8,8,0,22,22
c.thompson,0,0,0,0,2,2
c.tillman,0,3,3,0,3,3
c.tune,0,0,0,1,0,1
c.uzomah,0,0,0,0,10,10
c.watson,0,2,2,2,14,16
c.wentz,0,0,0,8,0,8
c.wilkins,0,0,0,0,1,1
c.wilson,0,1,1,0,12,12
co.heyward,0,1,1,0,2,2
d. d.achane,6,6,12,14,9,23
d. d.adams,0,8,8,0,61,61
d. d.allen,0,1,1,0,2,2
d. d.amendola,0,0,0,0,3,3
d. d.arnold,0,0,0,0,4,4
d. d.asiasi,0,0,0,0,1,1
d. d.bellinger,0,0,0,1,3,4
d. d.booker,0,0,0,5,1,6
d. d.brees,0,0,0,2,0,2
d. d.brown,0,2,2,0,5,5
d. d.bryant,0,0,0,0,2,2
d. d.byrd,0,0,0,0,4,4
d. d.carr,1,0,1,4,0,4
d. d.carter,0,0,0,0,6,6
d. d.chark,0,1,1,0,12,12
d. d.cook,0,0,0,30,3,33
d. d.dafney,0,0,0,0,1,1
d. d.dallas,0,1,1,4,2,6
d. d.daniels,0,0,0,0,1,1
d. d.davis,0,2,2,0,2,2
d. d.douglas,0,3,3,0,3,3
d. d.duvernay,0,0,0,1,5,6
d. d.eskridge,0,0,0,0,1,1
d. d.evans,0,0,0,1,1,2
d. d.fells,0,0,0,0,4,4
d. d.felton,0,0,0,0,2,2
d. d.fitzpatrick,0,0,0,0,1,1
d. d.foreman,0,0,0,12,2,14
d. d.freeman,0,0,0,6,1,7
d. d.goedert,0,3,3,0,18,18
d. d.gore,0,0,0,2,0,2
d. d.hamilton,0,0,0,0,2,2
d. d.harris,0,0,0,21,4,25
d. d.harty,0,0,0,0,1,1
d. d.haskins,0,0,0,1,0,1
d. d.henderson,0,0,0,15,4,19
d. d.henry,19,2,21,72,2,74
d. d.hilliard,0,0,0,2,4,6
d. d.hopkins,0,6,6,0,30,30
d. d.inman,0,0,0,0,2,2
d. d.jackson,0,0,0,1,4,5
d. d.johnson,0,0,0,9,23,32
d. d.jones,2,0,2,13,0,13
d. d.kincaid,0,2,2,0,5,5
d. d.knox,0,1,1,0,27,27
d. d.lewis,0,0,0,2,1,3
d. d.lock,2,0,2,7,0,7
d. d.london,0,9,9,0,15,15
d. d.maye,2,0,2,2,0,2
d. d.metcalf,0,5,5,0,45,45
d. d.mills,0,0,0,2,0,2
d. d.milne,0,0,0,0,1,1
d. d.montgomery,12,0,12,47,4,51
d. d.mooney,0,5,5,1,16,17
d. d.moore,0,9,9,1,36,37
d. d.njoku,0,5,5,0,21,21
d. d.ogunbowale,0,1,1,2,2,4
d. d.parham,0,0,0,0,8,8
d. d.parker,0,0,0,0,9,9
d. d.patmon,0,0,0,0,1,1
d. d.peoples-jones,0,0,0,0,8,8
d. d.pettis,0,1,1,0,6,6
d. d.pierce,2,0,2,8,1,9
d. d.pinter,0,0,0,0,1,1
d. d.prescott,1,0,1,10,1,11
d. d.ridder,0,0,0,5,0,5
d. d.robinson,0,7,7,0,20,20
d. d.sample,0,1,1,0,4,4
d. d.samuel,1,3,4,18,21,39
d. d.schultz,0,2,2,0,28,28
d. d.singletary,4,0,4,26,2,28
d. d.skipper,0,1,1,0,1,1
d. d.slayton,0,2,2,0,13,13
d. d.smith,0,9,9,0,29,29
d. d.smythe,0,0,0,1,3,4
d. d.swift,6,0,6,29,8,37
d. d.thompkins,0,0,0,0,1,1
d. d.thompson,0,0,0,1,1,2
d. d.turner,1,1,2,1,1,2
d. d.vele,0,3,3,0,3,3
d. d.walker,0,1,1,0,1,1
d. d.waller,0,0,0,0,15,15
d. d.washington,0,1,1,0,1,1
d. d.watson,1,0,1,6,0,6
d. d.watt,0,0,0,1,1,2
d. d.webb,0,0,0,1,0,1
d. d.wicks,0,5,5,0,10,10
d. d.williams,0,0,0,3,1,4
d. da.johnson,0,0,0,4,1,5
d. da.williams,0,0,0,6,2,8
d. darr.williams,0,0,0,2,0,2
d. dav.bell,0,0,0,0,3,3
d. de.jackson,0,0,0,1,0,1
d. di.johnson,0,2,2,0,4,4
d. dio.johnson,0,1,1,0,1,1
d. dj.moore,0,0,0,0,4,4
d. jr.,0,0,0,0,4,4
d.achane,6,6,12,14,9,23
d.adams,0,8,8,0,61,61
d.allen,0,1,1,0,2,2
d.amendola,0,0,0,0,3,3
d.arnold,0,0,0,0,4,4
d.asiasi,0,0,0,0,1,1
d.bellinger,0,0,0,1,3,4
d.booker,0,0,0,5,1,6
d.brees,0,0,0,2,0,2
d.brown,0,2,2,0,5,5
d.bryant,0,0,0,0,2,2
d.byrd,0,0,0,0,4,4
d.carr,1,0,1,4,0,4
d.carter,0,0,0,0,6,6
d.chark,0,1,1,0,12,12
d.chark jr.,0,0,0,0,4,4
d.cook,0,0,0,30,3,33
d.d.achane,6,6,12,14,9,23
d.d.adams,0,8,8,0,61,61
d.d.allen,0,1,1,0,2,2
d.d.amendola,0,0,0,0,3,3
d.d.arnold,0,0,0,0,4,4
d.d.asiasi,0,0,0,0,1,1
d.d.bellinger,0,0,0,1,3,4
d.d.booker,0,0,0,5,1,6
d.d.brees,0,0,0,2,0,2
d.d.brown,0,2,2,0,5,5
d.d.bryant,0,0,0,0,2,2
d.d.byrd,0,0,0,0,4,4
d.d.carr,1,0,1,4,0,4
d.d.carter,0,0,0,0,6,6
d.d.chark,0,1,1,0,12,12
d.d.cook,0,0,0,30,3,33
d.d.dafney,0,0,0,0,1,1
d.d.dallas,0,1,1,4,2,6
d.d.daniels,0,0,0,0,1,1
d.d.davis,0,2,2,0,2,2
d.d.douglas,0,3,3,0,3,3
d.d.duvernay,0,0,0,1,5,6
d.d.eskridge,0,0,0,0,1,1
d.d.evans,0,0,0,1,1,2
d.d.fells,0,0,0,0,4,4
d.d.felton,0,0,0,0,2,2
d.d.fitzpatrick,0,0,0,0,1,1
d.d.foreman,0,0,0,12,2,14
d.d.freeman,0,0,0,6,1,7
d.d.goedert,0,3,3,0,18,18
d.d.gore,0,0,0,2,0,2
d.d.hamilton,0,0,0,0,2,2
d.d.harris,0,0,0,21,4,25
d.d.harty,0,0,0,0,1,1
d.d.haskins,0,0,0,1,0,1
d.d.henderson,0,0,0,15,4,19
d.d.henry,19,2,21,72,2,74
d.d.hilliard,0,0,0,2,4,6
d.d.hopkins,0,6,6,0,30,30
d.d.inman,0,0,0,0,2,2
d.d.jackson,0,0,0,1,4,5
d.d.johnson,0,0,0,9,23,32
d.d.jones,2,0,2,13,0,13
d.d.kincaid,0,2,2,0,5,5
d.d.knox,0,1,1,0,27,27
d.d.lewis,0,0,0,2,1,3
d.d.lock,2,0,2,7,0,7
d.d.london,0,9,9,0,15,15
d.d.maye,2,0,2,2,0,2
d.d.metcalf,0,5,5,0,45,45
d.d.mills,0,0,0,2,0,2
d.d.milne,0,0,0,0,1,1
d.d.montgomery,12,0,12,47,4,51
d.d.mooney,0,5,5,1,16,17
d.d.moore,0,9,9,1,36,37
d.d.njoku,0,5,5,0,21,21
d.d.ogunbowale,0,1,1,2,2,4
d.d.parham,0,0,0,0,8,8
d.d.parker,0,0,0,0,9,9
d.d.patmon,0,0,0,0,1,1
d.d.peoples-jones,0,0,0,0,8,8
d.d.pettis,0,1,1,0,6,6
d.d.pierce,2,0,2,8,1,9
d.d.pinter,0,0,0,0,1,1
d.d.prescott,1,0,1,10,1,11
d.d.ridder,0,0,0,5,0,5
d.d.robinson,0,7,7,0,20,20
d.d.sample,0,1,1,0,4,4
d.d.samuel,1,3,4,18,21,39
d.d.schultz,0,2,2,0,28,28
d.d.singletary,4,0,4,26,2,28
d.d.skipper,0,1,1,0,1,1
d.d.slayton,0,2,2,0,13,13
d.d.smith,0,9,9,0,29,29
d.d.smythe,0,0,0,1,3,4
d.d.swift,6,0,6,29,8,37
d.d.thompkins,0,0,0,0,1,1
d.d.thompson,0,0,0,1,1,2
d.d.turner,1,1,2,1,1,2
d.d.vele,0,3,3,0,3,3
d.d.walker,0,1,1,0,1,1
d.d.waller,0,0,0,0,15,15
d.d.washington,0,1,1,0,1,1
d.d.watson,1,0,1,6,0,6
d.d.watt,0,0,0,1,1,2
d.d.webb,0,0,0,1,0,1
d.d.wicks,0,5,5,0,10,10
d.d.williams,0,0,0,3,1,4
d.da.johnson,0,0,0,4,1,5
d.da.williams,0,0,0,6,2,8
d.dafney,0,0,0,0,1,1
d.dallas,0,1,1,4,2,6
d.daniels,0,0,0,0,1,1
d.darr.williams,0,0,0,2,0,2
d.dav.bell,0,0,0,0,3,3
d.davis,0,2,2,0,2,2
d.de.jackson,0,0,0,1,0,1
d.di.johnson,0,2,2,0,4,4
d.dio.johnson,0,1,1,0,1,1
d.dj.moore,0,0,0,0,4,4
d.douglas,0,3,3,0,3,3
d.duvernay,0,0,0,1,5,6
d.eskridge,0,0,0,0,1,1
d.evans,0,0,0,1,1,2
d.fells,0,0,0,0,4,4
d.felton,0,0,0,0,2,2
d.fitzpatrick,0,0,0,0,1,1
d.foreman,0,0,0,12,2,14
d.freeman,0,0,0,6,1,7
d.goedert,0,3,3,0,18,18
d.gore,0,0,0,2,0,2
d.hamilton,0,0,0,0,2,2
d.harris,0,0,0,21,4,25
d.harty,0,0,0,0,1,1
d.haskins,0,0,0,1,0,1
d.henderson,0,0,0,15,4,19
d.henry,19,2,21,72,2,74
d.hilliard,0,0,0,2,4,6
d.hopkins,0,6,6,0,30,30
d.inman,0,0,0,0,2,2
d.jackson,0,0,0,1,4,5
d.johnson,0,0,0,9,23,32
d.jones,2,0,2,13,0,13
d.jr.,0,0,0,0,4,4
d.kincaid,0,2,2,0,5,5
d.knox,0,1,1,0,27,27
d.lewis,0,0,0,2,1,3
d.lock,2,0,2,7,0,7
d.london,0,9,9,0,15,15
d.maye,2,0,2,2,0,2
d.metcalf,0,5,5,0,45,45
d.mills,0,0,0,2,0,2
d.milne,0,0,0,0,1,1
d.montgomery,12,0,12,47,4,51
d.mooney,0,5,5,1,16,17
d.moore,0,9,9,1,36,37
d.njoku,0,5,5,0,21,21
d.ogunbowale,0,1,1,2,2,4
d.parham,0,0,0,0,8,8
d.parham jr.,0,0,0,0,3,3
d.parker,0,0,0,0,9,9
d.patmon,0,0,0,0,1,1
d.peoples-jones,0,0,0,0,8,8
d.pettis,0,1,1,0,6,6
d.pierce,2,0,2,8,1,9
d.pinter,0,0,0,0,1,1
d.prescott,1,0,1,10,1,11
d.ridder,0,0,0,5,0,5
d.robinson,0,7,7,0,20,20
d.sample,0,1,1,0,4,4
d.samuel,1,3,4,18,21,39
d.schultz,0,2,2,0,28,28
d.singletary,4,0,4,26,2,28
d.skipper,0,1,1,0,1,1
d.slayton,0,2,2,0,13,13
d.smith,0,9,9,0,29,29
d.smythe,0,0,0,1,3,4
d.swift,6,0,6,29,8,37
d.thompkins,0,0,0,0,1,1
d.thompson,0,0,0,1,1,2
d.turner,1,1,2,1,1,2
d.vele,0,3,3,0,3,3
d.walker,0,1,1,0,1,1
d.waller,0,0,0,0,15,15
d.washington,0,1,1,0,1,1
d.watson,1,0,1,6,0,6
d.watt,0,0,0,1,1,2
d.webb,0,0,0,1,0,1
d.wicks,0,5,5,0,10,10
d.williams,0,0,0,3,1,4
da.johnson,0,0,0,4,1,5
da.williams,0,0,0,6,2,8
darr.williams,0,0,0,2,0,2
dav.bell,0,0,0,0,3,3
de.jackson,0,0,0,1,0,1
di.johnson,0,2,2,0,4,4
dio.johnson,0,1,1,0,1,1
dj.moore,0,0,0,0,4,4
e. brown,0,0,0,0,2,2
e. e.benjamin,0,0,0,3,0,3
e. e.demercado,1,0,1,3,0,3
e. e.ebron,0,0,0,1,7,8
e. e.elliott,3,0,3,34,6,40
e. e.engram,0,1,1,1,14,15
e. e.fisher,0,0,0,0,1,1
e. e.higgins,0,2,2,0,3,3
e. e.jenkins,0,1,1,0,1,1
e. e.mitchell,0,0,0,11,2,13
e. e.moore,0,1,1,1,9,10
e. e.penny,0,0,0,1,1,2
e. e.sanders,0,0,0,0,10,10
e. e.saubert,0,1,1,0,3,3
e. e.stick,0,0,0,1,0,1
e. e.tomlinson,0,0,0,0,2,2
e. em.wilson,4,1,5,4,1,5
e.benjamin,0,0,0,3,0,3
e.brown,0,0,0,0,2,2
e.demercado,1,0,1,3,0,3
e.e.benjamin,0,0,0,3,0,3
e.e.demercado,1,0,1,3,0,3
e.e.ebron,0,0,0,1,7,8
e.e.elliott,3,0,3,34,6,40
e.e.engram,0,1,1,1,14,15
e.e.fisher,0,0,0,0,1,1
e.e.higgins,0,2,2,0,3,3
e.e.jenkins,0,1,1,0,1,1
e.e.mitchell,0,0,0,11,2,13
e.e.moore,0,1,1,1,9,10
e.e.penny,0,0,0,1,1,2
e.e.sanders,0,0,0,0,10,10
e.e.saubert,0,1,1,0,3,3
e.e.stick,0,0,0,1,0,1
e.e.tomlinson,0,0,0,0,2,2
e.ebron,0,0,0,1,7,8
e.elliott,3,0,3,34,6,40
e.em.wilson,4,1,5,4,1,5
e.engram,0,1,1,1,14,15
e.fisher,0,0,0,0,1,1
e.higgins,0,2,2,0,3,3
e.jenkins,0,1,1,0,1,1
e.mitchell,0,0,0,11,2,13
e.moore,0,1,1,1,9,10
e.penny,0,0,0,1,1,2
e.sanders,0,0,0,0,10,10
e.saubert,0,1,1,0,3,3
e.st. brown,0,0,0,0,2,2
e.stick,0,0,0,1,0,1
e.tomlinson,0,0,0,0,2,2
em.wilson,4,1,5,4,1,5
f. f.gore,0,0,0,2,0,2
f. f.moreau,0,5,5,0,13,13
f. f.swain,0,0,0,0,6,6
f.f.gore,0,0,0,2,0,2
f.f.moreau,0,5,5,0,13,13
f.f.swain,0,0,0,0,6,6
f.gore,0,0,0,2,0,2
f.moreau,0,5,5,0,13,13
f.swain,0,0,0,0,6,6
g. g.bernard,0,0,0,4,6,10
g. g.brightwell,0,0,0,1,0,1
g. g.calcaterra,0,1,1,0,1,1
g. g.davis,0,2,2,0,35,35
g. g.dortch,0,3,3,0,7,7
g. g.dulcich,0,0,0,0,2,2
g. g.edwards,4,0,4,26,0,26
g. g.everett,0,0,0,1,13,14
g. g.igwebuike,0,0,0,1,0,1
g. g.kittle,0,8,8,0,35,35
g. g.minshew,0,0,0,4,0,4
g. g.nabers,0,0,0,0,2,2
g. g.olsen,0,0,0,0,1,1
g. g.olszewski,0,0,0,0,1,1
g. g.pickens,0,4,4,1,13,14
g. g.smith,2,0,2,5,0,5
g. g.swaim,0,0,0,0,5,5
g. g.tate,0,0,0,0,2,2
g. g.ward,0,0,0,0,9,9
g. g.wilson,0,7,7,0,14,14
g. ii,0,0,0,1,0,1
g.bernard,0,0,0,4,6,10
g.brightwell,0,0,0,1,0,1
g.calcaterra,0,1,1,0,1,1
g.davis,0,2,2,0,35,35
g.dortch,0,3,3,0,7,7
g.dulcich,0,0,0,0,2,2
g.edwards,4,0,4,26,0,26
g.everett,0,0,0,1,13,14
g.g.bernard,0,0,0,4,6,10
g.g.brightwell,0,0,0,1,0,1
g.g.calcaterra,0,1,1,0,1,1
g.g.davis,0,2,2,0,35,35
g.g.dortch,0,3,3,0,7,7
g.g.dulcich,0,0,0,0,2,2
g.g.edwards,4,0,4,26,0,26
g.g.everett,0,0,0,1,13,14
g.g.igwebuike,0,0,0,1,0,1
g.g.kittle,0,8,8,0,35,35
g.g.minshew,0,0,0,4,0,4
g.g.nabers,0,0,0,0,2,2
g.g.olsen,0,0,0,0,1,1
g.g.olszewski,0,0,0,0,1,1
g.g.pickens,0,4,4,1,13,14
g.g.smith,2,0,2,5,0,5
g.g.swaim,0,0,0,0,5,5
g.g.tate,0,0,0,0,2,2
g.g.ward,0,0,0,0,9,9
g.g.wilson,0,7,7,0,14,14
g.igwebuike,0,0,0,1,0,1
g.ii,0,0,0,1,0,1
g.kittle,0,8,8,0,35,35
g.minshew,0,0,0,4,0,4
g.minshew ii,0,0,0,1,0,1
g.nabers,0,0,0,0,2,2
g.olsen,0,0,0,0,1,1
g.olszewski,0,0,0,0,1,1
g.pickens,0,4,4,1,13,14
g.smith,2,0,2,5,0,5
g.swaim,0,0,0,0,5,5
g.tate,0,0,0,0,2,2
g.ward,0,0,0,0,9,9
g.wilson,0,7,7,0,14,14
h. h.bryant,0,0,0,0,10,10
h. h.haskins,2,1,3,2,1,3
h. h.henry,0,2,2,0,23,23
h. h.hurst,0,0,0,0,13,13
h. h.luepke,0,0,0,1,0,1
h. h.renfrow,0,0,0,0,13,13
h. h.ruggs,0,0,0,0,4,4
h.bryant,0,0,0,0,10,10
h.h.bryant,0,0,0,0,10,10
h.h.haskins,2,1,3,2,1,3
h.h.henry,0,2,2,0,23,23
h.h.hurst,0,0,0,0,13,13
h.h.luepke,0,0,0,1,0,1
h.h.renfrow,0,0,0,0,13,13
h.h.ruggs,0,0,0,0,4,4
h.haskins,2,1,3,2,1,3
h.henry,0,2,2,0,23,23
h.hurst,0,0,0,0,13,13
h.luepke,0,0,0,1,0,1
h.renfrow,0,0,0,0,13,13
h.ruggs,0,0,0,0,4,4
i. i.davis,1,1,2,1,1,2
i. i.ford,0,0,0,0,2,2
i. i.guerendo,4,0,4,4,0,4
i. i.hodgins,0,0,0,0,8,8
i. i.likely,0,7,7,0,16,16
i. i.mckenzie,0,0,0,2,11,13
i. i.pacheco,1,0,1,17,2,19
i. i.smith,0,0,0,2,9,11
i. i.smith-marsette,0,0,0,1,2,3
i. i.thomas,0,0,0,0,1,1
i.davis,1,1,2,1,1,2
i.ford,0,0,0,0,2,2
i.guerendo,4,0,4,4,0,4
i.hodgins,0,0,0,0,8,8
i.i.davis,1,1,2,1,1,2
i.i.ford,0,0,0,0,2,2
i.i.guerendo,4,0,4,4,0,4
i.i.hodgins,0,0,0,0,8,8
i.i.likely,0,7,7,0,16,16
i.i.mckenzie,0,0,0,2,11,13
i.i.pacheco,1,0,1,17,2,19
i.i.smith,0,0,0,2,9,11
i.i.smith-marsette,0,0,0,1,2,3
i.i.thomas,0,0,0,0,1,1
i.likely,0,7,7,0,16,16
i.mckenzie,0,0,0,2,11,13
i.pacheco,1,0,1,17,2,19
i.smith,0,0,0,2,9,11
i.smith-marsette,0,0,0,1,2,3
i.thomas,0,0,0,0,1,1
j. j.adams,0,0,0,2,0,2
j. j.addison,1,9,10,1,19,20
j. j.agnew,0,0,0,1,5,6
j. j.akins,0,2,2,0,8,8
j. j.allen,14,0,14,54,1,55
j. j.bates,0,0,0,0,2,2
j. j.bobo,0,1,1,1,3,4
j. j.brissett,0,0,0,6,0,6
j. j.brooks,0,1,1,0,1,1
j. j.brown,0,0,0,0,4,4
j. j.browning,0,0,0,3,0,3
j. j.brownlee,0,0,0,0,1,1
j. j.burrow,2,0,2,13,0,13
j. j.cabinda,0,0,0,0,1,1
j. j.chase,0,17,17,0,49,49
j. j.coker,0,2,2,0,2,2
j. j.conner,8,1,9,45,7,52
j. j.cook,19,2,21,24,18,42
j. j.croom,0,0,0,0,1,1
j. j.crowder,0,2,2,0,11,11
j. j.daniels,7,0,7,7,0,7
j. j.deguara,0,0,0,0,2,2
j. j.dobbins,9,0,9,22,2,24
j. j.dobbs,2,0,2,8,0,8
j. j.dotson,0,1,1,0,12,12
j. j.downs,0,5,5,0,7,7
j. j.doyle,0,0,0,0,7,7
j. j.ferguson,0,0,0,0,10,10
j. j.fields,5,0,5,19,0,19
j. j.ford,3,0,3,7,5,12
j. j.fortson,0,0,0,0,4,4
j. j.garoppolo,0,0,0,5,0,5
j. j.gibbs,18,3,21,31,4,35
j. j.goff,0,1,1,6,1,7
j. j.gordon,0,0,0,0,1,1
j. j.graham,0,0,0,0,16,16
j. j.grant,0,0,0,0,3,3
j. j.guyton,0,0,0,0,7,7
j. j.hardy,0,0,0,1,0,1
j. j.hasty,0,1,1,4,2,6
j. j.herbert,2,0,2,13,0,13
j. j.hill,1,4,5,4,6,10
j. j.hollister,0,0,0,0,4,4
j. j.horsted,0,0,0,0,2,2
j. j.howard,0,0,0,7,0,7
j. j.hurts,19,0,19,65,0,65
j. j.jackson,0,0,0,3,1,4
j. j.jacobs,16,1,17,55,1,56
j. j.james,0,0,0,0,3,3
j. j.jefferson,0,10,10,3,40,43
j. j.jennings,0,6,6,0,14,14
j. j.jeudy,0,4,4,0,15,15
j. j.johnson,0,3,3,0,19,19
j. j.jones,0,0,0,0,10,10
j. j.kelley,0,0,0,6,0,6
j. j.kumerow,0,0,0,0,1,1
j. j.landry,0,0,0,3,8,11
j. j.love,1,0,1,5,0,5
j. j.luton,0,0,0,1,0,1
j. j.mason,3,0,3,7,0,7
j. j.mckinnon,0,0,0,7,16,23
j. j.mckissic,0,0,0,4,4,8
j. j.mclaughlin,1,2,3,2,4,6
j. j.mcmillan,0,8,8,0,8,8
j. j.mcnichols,5,0,5,6,1,7
j. j.metchie,0,1,1,0,1,1
j. j.meyers,0,4,4,2,20,22
j. j.milton,1,0,1,1,0,1
j. j.mitchell,0,0,0,0,1,1
j. j.mixon,13,1,14,47,10,57
j. j.mundt,0,2,2,0,4,4
j. j.nailor,0,6,6,0,7,7
j. j.oliver,0,3,3,0,7,7
j. j.palmer,0,1,1,0,10,10
j. j.patterson,0,0,0,2,0,2
j. j.polk,0,2,2,0,2,2
j. j.reagor,0,0,0,0,4,4
j. j.reed,1,6,7,4,18,22
j. j.reynolds,0,1,1,0,14,14
j. j.richard,0,0,0,1,0,1
j. j.robinson,0,0,0,18,5,23
j. j.ross,0,0,0,0,1,1
j. j.sanders,0,1,1,0,1,1
j. j.simmons,0,0,0,0,1,1
j. j.smith,0,8,8,1,20,21
j. j.smith-njigba,0,6,6,0,10,10
j. j.smith-schuster,0,2,2,1,16,17
j. j.stanton,0,0,0,0,1,1
j. j.sternberger,0,0,0,0,1,1
j. j.taylor,11,1,12,54,5,59
j. j.thomas,0,0,0,0,1,1
j. j.tolbert,0,7,7,0,9,9
j. j.virgil,0,0,0,0,1,1
j. j.waddle,0,2,2,1,20,21
j. j.ward,0,0,0,0,1,1
j. j.warren,1,0,1,6,0,6
j. j.washington,0,0,0,0,8,8
j. j.white,0,0,0,3,1,4
j. j.whyle,0,1,1,0,2,2
j. j.wilkins,0,0,0,1,0,1
j. j.williams,4,4,8,20,14,34
j. j.wilson,0,1,1,15,5,20
j. j.wims,0,0,0,0,1,1
j. j.winston,1,0,1,2,0,2
j. j.witten,0,0,0,0,2,2
j. j.woods,0,0,0,0,3,3
j. ja.williams,3,2,5,20,2,22
j. jos.allen,0,0,0,1,0,1
j. ju.watson,0,2,2,0,7,7
j.adams,0,0,0,2,0,2
j.addison,1,9,10,1,19,20
j.agnew,0,0,0,1,5,6
j.akins,0,2,2,0,8,8
j.allen,14,0,14,54,1,55
j.bates,0,0,0,0,2,2
j.bobo,0,1,1,1,3,4
j.brissett,0,0,0,6,0,6
j.brooks,0,1,1,0,1,1
j.brown,0,0,0,0,4,4
j.browning,0,0,0,3,0,3
j.brownlee,0,0,0,0,1,1
j.burrow,2,0,2,13,0,13
j.cabinda,0,0,0,0,1,1
j.chase,0,17,17,0,49,49
j.coker,0,2,2,0,2,2
j.conner,8,1,9,45,7,52
j.cook,19,2,21,24,18,42
j.croom,0,0,0,0,1,1
j.crowder,0,2,2,0,11,11
j.daniels,7,0,7,7,0,7
j.deguara,0,0,0,0,2,2
j.dobbins,9,0,9,22,2,24
j.dobbs,2,0,2,8,0,8
j.dotson,0,1,1,0,12,12
j.downs,0,5,5,0,7,7
j.doyle,0,0,0,0,7,7
j.ferguson,0,0,0,0,10,10
j.fields,5,0,5,19,0,19
j.ford,3,0,3,7,5,12
j.fortson,0,0,0,0,4,4
j.garoppolo,0,0,0,5,0,5
j.gibbs,18,3,21,31,4,35
j.goff,0,1,1,6,1,7
j.gordon,0,0,0,0,1,1
j.graham,0,0,0,0,16,16
j.grant,0,0,0,0,3,3
j.guyton,0,0,0,0,7,7
j.hardy,0,0,0,1,0,1
j.hasty,0,1,1,4,2,6
j.herbert,2,0,2,13,0,13
j.hill,1,4,5,4,6,10
j.hollister,0,0,0,0,4,4
j.horsted,0,0,0,0,2,2
j.howard,0,0,0,7,0,7
j.hurts,19,0,19,65,0,65
j.j.adams,0,0,0,2,0,2
j.j.addison,1,9,10,1,19,20
j.j.agnew,0,0,0,1,5,6
j.j.akins,0,2,2,0,8,8
j.j.allen,14,0,14,54,1,55
j.j.bates,0,0,0,0,2,2
j.j.bobo,0,1,1,1,3,4
j.j.brissett,0,0,0,6,0,6
j.j.brooks,0,1,1,0,1,1
j.j.brown,0,0,0,0,4,4
j.j.browning,0,0,0,3,0,3
j.j.brownlee,0,0,0,0,1,1
j.j.burrow,2,0,2,13,0,13
j.j.cabinda,0,0,0,0,1,1
j.j.chase,0,17,17,0,49,49
j.j.coker,0,2,2,0,2,2
j.j.conner,8,1,9,45,7,52
j.j.cook,19,2,21,24,18,42
j.j.croom,0,0,0,0,1,1
j.j.crowder,0,2,2,0,11,11
j.j.daniels,7,0,7,7,0,7
j.j.deguara,0,0,0,0,2,2
j.j.dobbins,9,0,9,22,2,24
j.j.dobbs,2,0,2,8,0,8
j.j.dotson,0,1,1,0,12,12
j.j.downs,0,5,5,0,7,7
j.j.doyle,0,0,0,0,7,7
j.j.ferguson,0,0,0,0,10,10
j.j.fields,5,0,5,19,0,19
j.j.ford,3,0,3,7,5,12
j.j.fortson,0,0,0,0,4,4
j.j.garoppolo,0,0,0,5,0,5
j.j.gibbs,18,3,21,31,4,35
j.j.goff,0,1,1,6,1,7
j.j.gordon,0,0,0,0,1,1
j.j.graham,0,0,0,0,16,16
j.j.grant,0,0,0,0,3,3
j.j.guyton,0,0,0,0,7,7
j.j.hardy,0,0,0,1,0,1
j.j.hasty,0,1,1,4,2,6
j.j.herbert,2,0,2,13,0,13
j.j.hill,1,4,5,4,6,10
j.j.hollister,0,0,0,0,4,4
j.j.horsted,0,0,0,0,2,2
j.j.howard,0,0,0,7,0,7
j.j.hurts,19,0,19,65,0,65
j.j.jackson,0,0,0,3,1,4
j.j.jacobs,16,1,17,55,1,56
j.j.james,0,0,0,0,3,3
j.j.jefferson,0,10,10,3,40,43
j.j.jennings,0,6,6,0,14,14
j.j.jeudy,0,4,4,0,15,15
j.j.johnson,0,3,3,0,19,19
j.j.jones,0,0,0,0,10,10
j.j.kelley,0,0,0,6,0,6
j.j.kumerow,0,0,0,0,1,1
j.j.landry,0,0,0,3,8,11
j.j.love,1,0,1,5,0,5
j.j.luton,0,0,0,1,0,1
j.j.mason,3,0,3,7,0,7
j.j.mckinnon,0,0,0,7,16,23
j.j.mckissic,0,0,0,4,4,8
j.j.mclaughlin,1,2,3,2,4,6
j.j.mcmillan,0,8,8,0,8,8
j.j.mcnichols,5,0,5,6,1,7
j.j.metchie,0,1,1,0,1,1
j.j.meyers,0,4,4,2,20,22
j.j.milton,1,0,1,1,0,1
j.j.mitchell,0,0,0,0,1,1
j.j.mixon,13,1,14,47,10,57
j.j.mundt,0,2,2,0,4,4
j.j.nailor,0,6,6,0,7,7
j.j.oliver,0,3,3,0,7,7
j.j.palmer,0,1,1,0,10,10
j.j.patterson,0,0,0,2,0,2
j.j.polk,0,2,2,0,2,2
j.j.reagor,0,0,0,0,4,4
j.j.reed,1,6,7,4,18,22
j.j.reynolds,0,1,1,0,14,14
j.j.richard,0,0,0,1,0,1
j.j.robinson,0,0,0,18,5,23
j.j.ross,0,0,0,0,1,1
j.j.sanders,0,1,1,0,1,1
j.j.simmons,0,0,0,0,1,1
j.j.smith,0,8,8,1,20,21
j.j.smith-njigba,0,6,6,0,10,10
j.j.smith-schuster,0,2,2,1,16,17
j.j.stanton,0,0,0,0,1,1
j.j.sternberger,0,0,0,0,1,1
j.j.taylor,11,1,12,54,5,59
j.j.thomas,0,0,0,0,1,1
j.j.tolbert,0,7,7,0,9,9
j.j.virgil,0,0,0,0,1,1
j.j.waddle,0,2,2,1,20,21
j.j.ward,0,0,0,0,1,1
j.j.warren,1,0,1,6,0,6
j.j.washington,0,0,0,0,8,8
j.j.white,0,0,0,3,1,4
j.j.whyle,0,1,1,0,2,2
j.j.wilkins,0,0,0,1,0,1
j.j.williams,4,4,8,20,14,34
j.j.wilson,0,1,1,15,5,20
j.j.wims,0,0,0,0,1,1
j.j.winston,1,0,1,2,0,2
j.j.witten,0,0,0,0,2,2
j.j.woods,0,0,0,0,3,3
j.ja.williams,3,2,5,20,2,22
j.jackson,0,0,0,3,1,4
j.jacobs,16,1,17,55,1,56
j.james,0,0,0,0,3,3
j.jefferson,0,10,10,3,40,43
j.jennings,0,6,6,0,14,14
j.jeudy,0,4,4,0,15,15
j.johnson,0,3,3,0,19,19
j.jones,0,0,0,0,10,10
j.jos.allen,0,0,0,1,0,1
j.ju.watson,0,2,2,0,7,7
j.kelley,0,0,0,6,0,6
j.kumerow,0,0,0,0,1,1
j.landry,0,0,0,3,8,11
j.love,1,0,1,5,0,5
j.luton,0,0,0,1,0,1
j.mason,3,0,3,7,0,7
j.mckinnon,0,0,0,7,16,23
j.mckissic,0,0,0,4,4,8
j.mclaughlin,1,2,3,2,4,6
j.mcmillan,0,8,8,0,8,8
j.mcnichols,5,0,5,6,1,7
j.metchie,0,1,1,0,1,1
j.meyers,0,4,4,2,20,22
j.milton,1,0,1,1,0,1
j.mitchell,0,0,0,0,1,1
j.mixon,13,1,14,47,10,57
j.mundt,0,2,2,0,4,4
j.nailor,0,6,6,0,7,7
j.oliver,0,3,3,0,7,7
j.palmer,0,1,1,0,10,10
j.patterson,0,0,0,2,0,2
j.polk,0,2,2,0,2,2
j.reagor,0,0,0,0,4,4
j.reed,1,6,7,4,18,22
j.reynolds,0,1,1,0,14,14
j.richard,0,0,0,1,0,1
j.robinson,0,0,0,18,5,23
j.ross,0,0,0,0,1,1
j.sanders,0,1,1,0,1,1
j.simmons,0,0,0,0,1,1
j.smith,0,8,8,1,20,21
j.smith-njigba,0,6,6,0,10,10
j.smith-schuster,0,2,2,1,16,17
j.stanton,0,0,0,0,1,1
j.sternberger,0,0,0,0,1,1
j.taylor,11,1,12,54,5,59
j.thomas,0,0,0,0,1,1
j.tolbert,0,7,7,0,9,9
j.virgil,0,0,0,0,1,1
j.waddle,0,2,2,1,20,21
j.ward,0,0,0,0,1,1
j.warren,1,0,1,6,0,6
j.washington,0,0,0,0,8,8
j.white,0,0,0,3,1,4
j.whyle,0,1,1,0,2,2
j.wilkins,0,0,0,1,0,1
j.williams,4,4,8,20,14,34
j.wilson,0,1,1,15,5,20
j.wims,0,0,0,0,1,1
j.winston,1,0,1,2,0,2
j.witten,0,0,0,0,2,2
j.woods,0,0,0,0,3,3
ja.williams,3,2,5,20,2,22
jos.allen,0,0,0,1,0,1
ju.watson,0,2,2,0,7,7
k. k.allen,0,7,7,1,32,33
k. k.ballage,0,0,0,3,0,3
k. k.blanton,0,0,0,0,1,1
k. k.bourne,0,1,1,0,15,15
k. k.boutte,0,3,3,0,3,3
k. k.cole,0,0,0,0,4,4
k. k.coleman,0,4,4,0,4,4
k. k.cousins,0,0,0,5,0,5
k. k.coutee,0,0,0,0,3,3
k. k.drake,0,0,0,16,2,18
k. k.gainwell,1,0,1,13,2,15
k. k.golladay,0,0,0,0,3,3
k. k.granson,0,0,0,0,1,1
k. k.hamler,0,0,0,0,3,3
k. k.harris,0,0,0,2,0,2
k. k.herbert,1,0,1,9,2,11
k. k.hinton,0,0,0,0,1,1
k. k.hodge,0,1,1,0,2,2
k. k.hunt,9,0,9,36,7,43
k. k.ingram,0,0,0,1,0,1
k. k.johnson,0,0,0,2,1,3
k. k.juszczyk,1,2,3,5,10,15
k. k.kieft,0,0,0,0,2,2
k. k.kirkwood,0,0,0,0,1,1
k. k.lamm,0,0,0,0,1,1
k. k.miller,1,0,1,2,0,2
k. k.mitchell,0,0,0,2,0,2
k. k.murray,5,0,5,27,0,27
k. k.osborn,0,1,1,0,17,17
k. k.pickett,1,0,1,5,0,5
k. k.pitts,0,4,4,0,10,10
k. k.raymond,0,2,2,0,7,7
k. k.rudolph,0,0,0,0,3,3
k. k.shakir,0,4,4,0,9,9
k. k.stills,0,0,0,0,2,2
k. k.toney,0,0,0,1,4,5
k. k.turpin,0,2,2,1,5,6
k. k.vaughn,0,0,0,3,1,4
k. k.vidal,0,1,1,0,1,1
k. k.walker,7,1,8,25,2,27
k. k.wilkerson,0,1,1,0,3,3
k. k.williams,14,3,17,26,6,32
k. k.yeboah,0,1,1,0,1,1
k. sr.,0,0,0,0,3,3
k.allen,0,7,7,1,32,33
k.ballage,0,0,0,3,0,3
k.blanton,0,0,0,0,1,1
k.bourne,0,1,1,0,15,15
k.boutte,0,3,3,0,3,3
k.cole,0,0,0,0,4,4
k.cole sr.,0,0,0,0,3,3
k.coleman,0,4,4,0,4,4
k.cousins,0,0,0,5,0,5
k.coutee,0,0,0,0,3,3
k.drake,0,0,0,16,2,18
k.gainwell,1,0,1,13,2,15
k.golladay,0,0,0,0,3,3
k.granson,0,0,0,0,1,1
k.hamler,0,0,0,0,3,3
k.harris,0,0,0,2,0,2
k.herbert,1,0,1,9,2,11
k.hinton,0,0,0,0,1,1
k.hodge,0,1,1,0,2,2
k.hunt,9,0,9,36,7,43
k.ingram,0,0,0,1,0,1
k.johnson,0,0,0,2,1,3
k.juszczyk,1,2,3,5,10,15
k.k.allen,0,7,7,1,32,33
k.k.ballage,0,0,0,3,0,3
k.k.blanton,0,0,0,0,1,1
k.k.bourne,0,1,1,0,15,15
k.k.boutte,0,3,3,0,3,3
k.k.cole,0,0,0,0,4,4
k.k.coleman,0,4,4,0,4,4
k.k.cousins,0,0,0,5,0,5
k.k.coutee,0,0,0,0,3,3
k.k.drake,0,0,0,16,2,18
k.k.gainwell,1,0,1,13,2,15
k.k.golladay,0,0,0,0,3,3
k.k.granson,0,0,0,0,1,1
k.k.hamler,0,0,0,0,3,3
k.k.harris,0,0,0,2,0,2
k.k.herbert,1,0,1,9,2,11
k.k.hinton,0,0,0,0,1,1
k.k.hodge,0,1,1,0,2,2
k.k.hunt,9,0,9,36,7,43
k.k.ingram,0,0,0,1,0,1
k.k.johnson,0,0,0,2,1,3
k.k.juszczyk,1,2,3,5,10,15
k.k.kieft,0,0,0,0,2,2
k.k.kirkwood,0,0,0,0,1,1
k.k.lamm,0,0,0,0,1,1
k.k.miller,1,0,1,2,0,2
k.k.mitchell,0,0,0,2,0,2
k.k.murray,5,0,5,27,0,27
k.k.osborn,0,1,1,0,17,17
k.k.pickett,1,0,1,5,0,5
k.k.pitts,0,4,4,0,10,10
k.k.raymond,0,2,2,0,7,7
k.k.rudolph,0,0,0,0,3,3
k.k.shakir,0,4,4,0,9,9
k.k.stills,0,0,0,0,2,2
k.k.toney,0,0,0,1,4,5
k.k.turpin,0,2,2,1,5,6
k.k.vaughn,0,0,0,3,1,4
k.k.vidal,0,1,1,0,1,1
k.k.walker,7,1,8,25,2,27
k.k.wilkerson,0,1,1,0,3,3
k.k.williams,14,3,17,26,6,32
k.k.yeboah,0,1,1,0,1,1
k.kieft,0,0,0,0,2,2
k.kirkwood,0,0,0,0,1,1
k.lamm,0,0,0,0,1,1
k.miller,1,0,1,2,0,2
k.mitchell,0,0,0,2,0,2
k.murray,5,0,5,27,0,27
k.osborn,0,1,1,0,17,17
k.pickett,1,0,1,5,0,5
k.pitts,0,4,4,0,10,10
k.raymond,0,2,2,0,7,7
k.rudolph,0,0,0,0,3,3
k.shakir,0,4,4,0,9,9
k.sr.,0,0,0,0,3,3
k.stills,0,0,0,0,2,2
k.toney,0,0,0,1,4,5
k.turpin,0,2,2,1,5,6
k.vaughn,0,0,0,3,1,4
k.vidal,0,1,1,0,1,1
k.walker,7,1,8,25,2,27
k.wilkerson,0,1,1,0,3,3
k.williams,14,3,17,26,6,32
k.yeboah,0,1,1,0,1,1
l. jr.,0,0,0,0,4,4
l. l.bell,0,0,0,3,1,4
l. l.cager,0,0,0,0,2,2
l. l.fitzgerald,0,0,0,0,1,1
l. l.fournette,0,0,0,22,6,28
l. l.humphrey,0,1,1,0,7,7
l. l.jackson,4,0,4,24,0,24
l. l.johnson,0,0,0,0,1,1
l. l.krull,0,0,0,0,1,1
l. l.mcconkey,0,8,8,0,8,8
l. l.murray,0,0,0,20,2,22
l. l.musgrave,0,0,0,0,2,2
l. l.perine,0,0,0,2,0,2
l. l.rountree,0,0,0,1,0,1
l. l.schoonmaker,0,1,1,0,3,3
l. l.shenault,0,0,0,1,2,3
l. l.smith,0,0,0,0,3,3
l. l.thomas,0,0,0,0,14,14
l. l.treadwell,0,0,0,0,3,3
l.bell,0,0,0,3,1,4
l.cager,0,0,0,0,2,2
l.fitzgerald,0,0,0,0,1,1
l.fournette,0,0,0,22,6,28
l.humphrey,0,1,1,0,7,7
l.jackson,4,0,4,24,0,24
l.johnson,0,0,0,0,1,1
l.jr.,0,0,0,0,4,4
l.krull,0,0,0,0,1,1
l.l.bell,0,0,0,3,1,4
l.l.cager,0,0,0,0,2,2
l.l.fitzgerald,0,0,0,0,1,1
l.l.fournette,0,0,0,22,6,28
l.l.humphrey,0,1,1,0,7,7
l.l.jackson,4,0,4,24,0,24
l.l.johnson,0,0,0,0,1,1
l.l.krull,0,0,0,0,1,1
l.l.mcconkey,0,8,8,0,8,8
l.l.murray,0,0,0,20,2,22
l.l.musgrave,0,0,0,0,2,2
l.l.perine,0,0,0,2,0,2
l.l.rountree,0,0,0,1,0,1
l.l.schoonmaker,0,1,1,0,3,3
l.l.shenault,0,0,0,1,2,3
l.l.smith,0,0,0,0,3,3
l.l.thomas,0,0,0,0,14,14
l.l.treadwell,0,0,0,0,3,3
l.mcconkey,0,8,8,0,8,8
l.murray,0,0,0,20,2,22
l.musgrave,0,0,0,0,2,2
l.perine,0,0,0,2,0,2
l.rountree,0,0,0,1,0,1
l.schoonmaker,0,1,1,0,3,3
l.shenault,0,0,0,1,2,3
l.shenault jr.,0,0,0,0,4,4
l.smith,0,0,0,0,3,3
l.thomas,0,0,0,0,14,14
l.treadwell,0,0,0,0,3,3
m. m.alie-cox,0,1,1,0,13,13
m. m.andrews,0,11,11,0,38,38
m. m.boone,0,0,0,1,0,1
m. m.boykin,0,0,0,0,4,4
m. m.breida,0,0,0,4,2,6
m. m.brown,0,0,0,7,21,28
m. m.burton,1,1,2,2,1,3
m. m.callaway,0,0,0,0,7,7
m. m.carter,1,0,1,1,1,2
m. m.davis,0,0,0,10,3,13
m. m.evans,0,12,12,0,63,63
m. m.gallup,0,0,0,0,14,14
m. m.gaskin,0,0,0,6,6,12
m. m.gesicki,0,2,2,0,18,18
m. m.glennon,0,0,0,1,0,1
m. m.goodwin,0,0,0,0,5,5
m. m.gordon,0,0,0,20,3,23
m. m.hall,0,0,0,0,2,2
m. m.hardman,1,0,1,4,13,17
m. m.harrison,0,8,8,0,8,8
m. m.heath,0,2,2,0,3,3
m. m.hollins,0,6,6,0,15,15
m. m.ingram,0,0,0,5,0,5
m. m.jones,1,0,1,2,17,19
m. m.lewis,0,0,0,0,6,6
m. m.mack,0,0,0,1,1,2
m. m.mariota,1,0,1,7,0,7
m. m.mayer,0,0,0,0,2,2
m. m.mims,0,6,6,0,7,7
m. m.nabers,0,7,7,0,7,7
m. m.penix,1,0,1,1,0,1
m. m.perry,0,0,0,0,1,1
m. m.pittman,0,3,3,0,18,18
m. m.pruitt,0,1,1,0,11,11
m. m.rudolph,1,0,1,1,0,1
m. m.ryan,0,0,0,4,0,4
m. m.sanders,2,1,3,22,1,23
m. m.sanu,0,0,0,0,1,1
m. m.stafford,0,0,0,3,0,3
m. m.taylor,0,0,0,0,1,1
m. m.thomas,0,0,0,0,6,6
m. m.trubisky,0,0,0,6,0,6
m. m.turner,0,0,0,0,3,3
m. m.valdes-scantling,0,4,4,0,20,20
m. m.washington,1,0,1,1,0,1
m. m.white,0,0,0,1,0,1
m. m.wilcox,0,0,0,0,1,1
m. m.williams,0,1,1,0,22,22
m. m.willis,1,0,1,2,0,2
m. ma.jones,0,0,0,0,1,1
m. mi.carter,0,0,0,7,0,7
m. mi.wilson,0,4,4,0,7,7
m.alie-cox,0,1,1,0,13,13
m.andrews,0,11,11,0,38,38
m.boone,0,0,0,1,0,1
m.boykin,0,0,0,0,4,4
m.breida,0,0,0,4,2,6
m.brown,0,0,0,7,21,28
m.burton,1,1,2,2,1,3
m.callaway,0,0,0,0,7,7
m.carter,1,0,1,1,1,2
m.davis,0,0,0,10,3,13
m.evans,0,12,12,0,63,63
m.gallup,0,0,0,0,14,14
m.gaskin,0,0,0,6,6,12
m.gesicki,0,2,2,0,18,18
m.glennon,0,0,0,1,0,1
m.goodwin,0,0,0,0,5,5
m.gordon,0,0,0,20,3,23
m.hall,0,0,0,0,2,2
m.hardman,1,0,1,4,13,17
m.harrison,0,8,8,0,8,8
m.heath,0,2,2,0,3,3
m.hollins,0,6,6,0,15,15
m.ingram,0,0,0,5,0,5
m.jones,1,0,1,2,17,19
m.lewis,0,0,0,0,6,6
m.m.alie-cox,0,1,1,0,13,13
m.m.andrews,0,11,11,0,38,38
m.m.boone,0,0,0,1,0,1
m.m.boykin,0,0,0,0,4,4
m.m.breida,0,0,0,4,2,6
m.m.brown,0,0,0,7,21,28
m.m.burton,1,1,2,2,1,3
m.m.callaway,0,0,0,0,7,7
m.m.carter,1,0,1,1,1,2
m.m.davis,0,0,0,10,3,13
m.m.evans,0,12,12,0,63,63
m.m.gallup,0,0,0,0,14,14
m.m.gaskin,0,0,0,6,6,12
m.m.gesicki,0,2,2,0,18,18
m.m.glennon,0,0,0,1,0,1
m.m.goodwin,0,0,0,0,5,5
m.m.gordon,0,0,0,20,3,23
m.m.hall,0,0,0,0,2,2
m.m.hardman,1,0,1,4,13,17
m.m.harrison,0,8,8,0,8,8
m.m.heath,0,2,2,0,3,3
m.m.hollins,0,6,6,0,15,15
m.m.ingram,0,0,0,5,0,5
m.m.jones,1,0,1,2,17,19
m.m.lewis,0,0,0,0,6,6
m.m.mack,0,0,0,1,1,2
m.m.mariota,1,0,1,7,0,7
m.m.mayer,0,0,0,0,2,2
m.m.mims,0,6,6,0,7,7
m.m.nabers,0,7,7,0,7,7
m.m.penix,1,0,1,1,0,1
m.m.perry,0,0,0,0,1,1
m.m.pittman,0,3,3,0,18,18
m.m.pruitt,0,1,1,0,11,11
m.m.rudolph,1,0,1,1,0,1
m.m.ryan,0,0,0,4,0,4
m.m.sanders,2,1,3,22,1,23
m.m.sanu,0,0,0,0,1,1
m.m.stafford,0,0,0,3,0,3
m.m.taylor,0,0,0,0,1,1
m.m.thomas,0,0,0,0,6,6
m.m.trubisky,0,0,0,6,0,6
m.m.turner,0,0,0,0,3,3
m.m.valdes-scantling,0,4,4,0,20,20
m.m.washington,1,0,1,1,0,1
m.m.white,0,0,0,1,0,1
m.m.wilcox,0,0,0,0,1,1
m.m.williams,0,1,1,0,22,22
m.m.willis,1,0,1,2,0,2
m.ma.jones,0,0,0,0,1,1
m.mack,0,0,0,1,1,2
m.mariota,1,0,1,7,0,7
m.mayer,0,0,0,0,2,2
m.mi.carter,0,0,0,7,0,7
m.mi.wilson,0,4,4,0,7,7
m.mims,0,6,6,0,7,7
m.nabers,0,7,7,0,7,7
m.penix,1,0,1,1,0,1
m.perry,0,0,0,0,1,1
m.pittman,0,3,3,0,18,18
m.pruitt,0,1,1,0,11,11
m.rudolph,1,0,1,1,0,1
m.ryan,0,0,0,4,0,4
m.sanders,2,1,3,22,1,23
m.sanu,0,0,0,0,1,1
m.stafford,0,0,0,3,0,3
m.taylor,0,0,0,0,1,1
m.thomas,0,0,0,0,6,6
m.trubisky,0,0,0,6,0,6
m.turner,0,0,0,0,3,3
m.valdes-scantling,0,4,4,0,20,20
m.washington,1,0,1,1,0,1
m.white,0,0,0,1,0,1
m.wilcox,0,0,0,0,1,1
m.williams,0,1,1,0,22,22
m.willis,1,0,1,2,0,2
ma.jones,0,0,0,0,1,1
mi.carter,0,0,0,7,0,7
mi.wilson,0,4,4,0,7,7
n. n.adkins,0,3,3,0,3,3
n. n.agholor,0,2,2,0,20,20
n. n.allegretti,0,0,0,0,1,1
n. n.bawden,0,0,0,1,0,1
n. n.boyle,0,0,0,0,2,2
n. n.brown,0,1,1,0,6,6
n. n.chubb,3,1,4,35,4,39
n. n.collins,0,8,8,0,20,20
n. n.dell,0,0,0,0,6,6
n. n.fant,0,1,1,0,12,12
n. n.foles,0,0,0,1,0,1
n. n.gray,0,5,5,1,9,10
n. n.harris,6,0,6,28,6,34
n. n.harry,0,0,0,0,3,3
n. n.hines,0,0,0,6,6,12
n. n.vannett,0,3,3,0,5,5
n. n.westbrook-ikhine,0,9,9,0,19,19
n.adkins,0,3,3,0,3,3
n.agholor,0,2,2,0,20,20
n.allegretti,0,0,0,0,1,1
n.bawden,0,0,0,1,0,1
n.boyle,0,0,0,0,2,2
n.brown,0,1,1,0,6,6
n.chubb,3,1,4,35,4,39
n.collins,0,8,8,0,20,20
n.dell,0,0,0,0,6,6
n.fant,0,1,1,0,12,12
n.foles,0,0,0,1,0,1
n.gray,0,5,5,1,9,10
n.harris,6,0,6,28,6,34
n.harry,0,0,0,0,3,3
n.hines,0,0,0,6,6,12
n.n.adkins,0,3,3,0,3,3
n.n.agholor,0,2,2,0,20,20
n.n.allegretti,0,0,0,0,1,1
n.n.bawden,0,0,0,1,0,1
n.n.boyle,0,0,0,0,2,2
n.n.brown,0,1,1,0,6,6
n.n.chubb,3,1,4,35,4,39
n.n.collins,0,8,8,0,20,20
n.n.dell,0,0,0,0,6,6
n.n.fant,0,1,1,0,12,12
n.n.foles,0,0,0,1,0,1
n.n.gray,0,5,5,1,9,10
n.n.harris,6,0,6,28,6,34
n.n.harry,0,0,0,0,3,3
n.n.hines,0,0,0,6,6,12
n.n.vannett,0,3,3,0,5,5
n.n.westbrook-ikhine,0,9,9,0,19,19
n.vannett,0,3,3,0,5,5
n.westbrook-ikhine,0,9,9,0,19,19
o. o.beckham,0,0,0,1,13,14
o. o.howard,0,0,0,0,5,5
o. o.zaccheaus,0,3,3,0,12,12
o.beckham,0,0,0,1,13,14
o.howard,0,0,0,0,5,5
o.o.beckham,0,0,0,1,13,14
o.o.howard,0,0,0,0,5,5
o.o.zaccheaus,0,3,3,0,12,12
o.zaccheaus,0,3,3,0,12,12
p. p.barber,0,0,0,6,0,6
p. p.brown,0,0,0,0,3,3
p. p.campbell,0,1,1,0,5,5
p. p.dorsett,0,0,0,0,1,1
p. p.durham,0,2,2,0,2,2
p. p.freiermuth,0,7,7,0,18,18
p. p.hendershot,0,0,0,1,2,3
p. p.lindsay,0,0,0,2,1,3
p. p.mahomes,4,0,4,15,0,15
p. p.nacua,1,3,4,1,10,11
p. p.ricard,0,1,1,0,4,4
p. p.strong,0,0,0,2,0,2
p. p.taylor,1,0,1,2,0,2
p. p.washington,0,3,3,0,5,5
p. p.williams,0,0,0,0,4,4
p.barber,0,0,0,6,0,6
p.brown,0,0,0,0,3,3
p.campbell,0,1,1,0,5,5
p.dorsett,0,0,0,0,1,1
p.durham,0,2,2,0,2,2
p.freiermuth,0,7,7,0,18,18
p.hendershot,0,0,0,1,2,3
p.lindsay,0,0,0,2,1,3
p.mahomes,4,0,4,15,0,15
p.nacua,1,3,4,1,10,11
p.p.barber,0,0,0,6,0,6
p.p.brown,0,0,0,0,3,3
p.p.campbell,0,1,1,0,5,5
p.p.dorsett,0,0,0,0,1,1
p.p.durham,0,2,2,0,2,2
p.p.freiermuth,0,7,7,0,18,18
p.p.hendershot,0,0,0,1,2,3
p.p.lindsay,0,0,0,2,1,3
p.p.mahomes,4,0,4,15,0,15
p.p.nacua,1,3,4,1,10,11
p.p.ricard,0,1,1,0,4,4
p.p.strong,0,0,0,2,0,2
p.p.taylor,1,0,1,2,0,2
p.p.washington,0,3,3,0,5,5
p.p.williams,0,0,0,0,4,4
p.ricard,0,1,1,0,4,4
p.strong,0,0,0,2,0,2
p.taylor,1,0,1,2,0,2
p.washington,0,3,3,0,5,5
p.williams,0,0,0,0,4,4
q. q.cephus,0,0,0,0,4,4
q. q.johnston,0,8,8,0,10,10
q. q.morris,0,1,1,0,3,3
q. q.ollison,0,0,0,1,0,1
q. q.watkins,0,0,0,0,6,6
q.cephus,0,0,0,0,4,4
q.johnston,0,8,8,0,10,10
q.morris,0,1,1,0,3,3
q.ollison,0,0,0,1,0,1
q.q.cephus,0,0,0,0,4,4
q.q.johnston,0,8,8,0,10,10
q.q.morris,0,1,1,0,3,3
q.q.ollison,0,0,0,1,0,1
q.q.watkins,0,0,0,0,6,6
q.watkins,0,0,0,0,6,6
r. r.anderson,0,0,0,0,9,9
r. r.bateman,0,11,11,0,15,15
r. r.bell,0,0,0,0,3,3
r. r.blackshear,0,0,0,3,0,3
r. r.bonnafon,0,0,0,0,1,1
r. r.burkhead,0,0,0,6,4,10
r. r.chosen,0,0,0,0,1,1
r. r.cobb,0,0,0,0,10,10
r. r.cracraft,0,0,0,0,3,3
r. r.davis,4,3,7,4,3,7
r. r.doubs,0,4,4,0,16,16
r. r.dowdle,2,3,5,4,5,9
r. r.dwelley,0,0,0,0,3,3
r. r.finley,0,0,0,1,0,1
r. r.fitzpatrick,0,0,0,2,0,2
r. r.freeman,0,0,0,2,0,2
r. r.gage,0,0,0,0,13,13
r. r.gilliam,0,0,0,0,2,2
r. r.griffin,0,0,0,0,2,2
r. r.gronkowski,0,0,0,0,16,16
r. r.higgins,0,0,0,0,5,5
r. r.james,0,0,0,0,5,5
r. r.johnson,6,0,6,8,0,8
r. r.jones,0,0,0,12,1,13
r. r.mccloud,0,1,1,1,2,3
r. r.miller,0,2,2,0,2,2
r. r.moore,0,0,0,1,3,4
r. r.mostert,2,0,2,25,6,31
r. r.nall,0,0,0,0,1,1
r. r.odunze,0,3,3,0,3,3
r. r.pearsall,0,3,3,0,3,3
r. r.penny,0,0,0,8,0,8
r. r.rice,0,2,2,0,10,10
r. r.rodgers,0,0,0,0,2,2
r. r.seals-jones,0,0,0,0,2,2
r. r.shaheed,0,3,3,1,10,11
r. r.smith,0,0,0,1,0,1
r. r.stevenson,7,1,8,21,2,23
r. r.tannehill,0,0,0,17,0,17
r. r.tonyan,0,0,0,0,16,16
r. r.white,3,6,9,10,12,22
r. r.wilson,2,0,2,12,0,12
r. r.woods,0,0,0,3,14,17
r.anderson,0,0,0,0,9,9
r.bateman,0,11,11,0,15,15
r.bell,0,0,0,0,3,3
r.blackshear,0,0,0,3,0,3
r.bonnafon,0,0,0,0,1,1
r.burkhead,0,0,0,6,4,10
r.chosen,0,0,0,0,1,1
r.cobb,0,0,0,0,10,10
r.cracraft,0,0,0,0,3,3
r.davis,4,3,7,4,3,7
r.doubs,0,4,4,0,16,16
r.dowdle,2,3,5,4,5,9
r.dwelley,0,0,0,0,3,3
r.finley,0,0,0,1,0,1
r.fitzpatrick,0,0,0,2,0,2
r.freeman,0,0,0,2,0,2
r.gage,0,0,0,0,13,13
r.gilliam,0,0,0,0,2,2
r.griffin,0,0,0,0,2,2
r.gronkowski,0,0,0,0,16,16
r.higgins,0,0,0,0,5,5
r.james,0,0,0,0,5,5
r.johnson,6,0,6,8,0,8
r.jones,0,0,0,12,1,13
r.mccloud,0,1,1,1,2,3
r.miller,0,2,2,0,2,2
r.moore,0,0,0,1,3,4
r.mostert,2,0,2,25,6,31
r.nall,0,0,0,0,1,1
r.odunze,0,3,3,0,3,3
r.pearsall,0,3,3,0,3,3
r.penny,0,0,0,8,0,8
r.r.anderson,0,0,0,0,9,9
r.r.bateman,0,11,11,0,15,15
r.r.bell,0,0,0,0,3,3
r.r.blackshear,0,0,0,3,0,3
r.r.bonnafon,0,0,0,0,1,1
r.r.burkhead,0,0,0,6,4,10
r.r.chosen,0,0,0,0,1,1
r.r.cobb,0,0,0,0,10,10
r.r.cracraft,0,0,0,0,3,3
r.r.davis,4,3,7,4,3,7
r.r.doubs,0,4,4,0,16,16
r.r.dowdle,2,3,5,4,5,9
r.r.dwelley,0,0,0,0,3,3
r.r.finley,0,0,0,1,0,1
r.r.fitzpatrick,0,0,0,2,0,2
r.r.freeman,0,0,0,2,0,2
r.r.gage,0,0,0,0,13,13
r.r.gilliam,0,0,0,0,2,2
r.r.griffin,0,0,0,0,2,2
r.r.gronkowski,0,0,0,0,16,16
r.r.higgins,0,0,0,0,5,5
r.r.james,0,0,0,0,5,5
r.r.johnson,6,0,6,8,0,8
r.r.jones,0,0,0,12,1,13
r.r.mccloud,0,1,1,1,2,3
r.r.miller,0,2,2,0,2,2
r.r.moore,0,0,0,1,3,4
r.r.mostert,2,0,2,25,6,31
r.r.nall,0,0,0,0,1,1
r.r.odunze,0,3,3,0,3,3
r.r.pearsall,0,3,3,0,3,3
r.r.penny,0,0,0,8,0,8
r.r.rice,0,2,2,0,10,10
r.r.rodgers,0,0,0,0,2,2
r.r.seals-jones,0,0,0,0,2,2
r.r.shaheed,0,3,3,1,10,11
r.r.smith,0,0,0,1,0,1
r.r.stevenson,7,1,8,21,2,23
r.r.tannehill,0,0,0,17,0,17
r.r.tonyan,0,0,0,0,16,16
r.r.white,3,6,9,10,12,22
r.r.wilson,2,0,2,12,0,12
r.r.woods,0,0,0,3,14,17
r.rice,0,2,2,0,10,10
r.rodgers,0,0,0,0,2,2
r.seals-jones,0,0,0,0,2,2
r.shaheed,0,3,3,1,10,11
r.smith,0,0,0,1,0,1
r.stevenson,7,1,8,21,2,23
r.tannehill,0,0,0,17,0,17
r.tonyan,0,0,0,0,16,16
r.white,3,6,9,10,12,22
r.wilson,2,0,2,12,0,12
r.woods,0,0,0,3,14,17
s. s.ahmed,0,0,0,5,1,6
s. s.anderson,0,0,0,0,1,1
s. s.barkley,18,2,20,38,8,46
s. s.conner,0,0,0,1,0,1
s. s.darnold,1,0,1,11,0,11
s. s.diggs,1,3,4,1,42,43
s. s.fehoko,0,0,0,0,1,1
s. s.howell,0,0,0,6,0,6
s. s.hubbard,0,1,1,0,1,1
s. s.laporta,0,8,8,0,19,19
s. s.mckeon,0,0,0,0,1,1
s. s.michel,0,0,0,5,2,7
s. s.miller,0,0,0,1,6,7
s. s.moore,0,0,0,0,2,2
s. s.perine,1,1,2,9,7,16
s. s.shepard,0,1,1,1,7,8
s. s.sims,0,0,0,0,2,2
s. s.smartt,0,0,0,0,1,1
s. s.smith,0,0,0,0,2,2
s. s.toure,0,0,0,0,1,1
s. s.tucker,2,1,3,2,1,3
s. s.watkins,0,0,0,0,3,3
s. s.zylstra,0,0,0,0,4,4
s.ahmed,0,0,0,5,1,6
s.anderson,0,0,0,0,1,1
s.barkley,18,2,20,38,8,46
s.conner,0,0,0,1,0,1
s.darnold,1,0,1,11,0,11
s.diggs,1,3,4,1,42,43
s.fehoko,0,0,0,0,1,1
s.howell,0,0,0,6,0,6
s.hubbard,0,1,1,0,1,1
s.laporta,0,8,8,0,19,19
s.mckeon,0,0,0,0,1,1
s.michel,0,0,0,5,2,7
s.miller,0,0,0,1,6,7
s.moore,0,0,0,0,2,2
s.perine,1,1,2,9,7,16
s.s.ahmed,0,0,0,5,1,6
s.s.anderson,0,0,0,0,1,1
s.s.barkley,18,2,20,38,8,46
s.s.conner,0,0,0,1,0,1
s.s.darnold,1,0,1,11,0,11
s.s.diggs,1,3,4,1,42,43
s.s.fehoko,0,0,0,0,1,1
s.s.howell,0,0,0,6,0,6
s.s.hubbard,0,1,1,0,1,1
s.s.laporta,0,8,8,0,19,19
s.s.mckeon,0,0,0,0,1,1
s.s.michel,0,0,0,5,2,7
s.s.miller,0,0,0,1,6,7
s.s.moore,0,0,0,0,2,2
s.s.perine,1,1,2,9,7,16
s.s.shepard,0,1,1,1,7,8
s.s.sims,0,0,0,0,2,2
s.s.smartt,0,0,0,0,1,1
s.s.smith,0,0,0,0,2,2
s.s.toure,0,0,0,0,1,1
s.s.tucker,2,1,3,2,1,3
s.s.watkins,0,0,0,0,3,3
s.s.zylstra,0,0,0,0,4,4
s.shepard,0,1,1,1,7,8
s.sims,0,0,0,0,2,2
s.smartt,0,0,0,0,1,1
s.smith,0,0,0,0,2,2
s.toure,0,0,0,0,1,1
s.tucker,2,1,3,2,1,3
s.watkins,0,0,0,0,3,3
s.zylstra,0,0,0,0,4,4
t. t.allgeier,3,0,3,10,2,12
t. t.atwell,0,0,0,1,5,6
t. t.austin,0,0,0,0,1,1
t. t.badie,0,0,0,0,1,1
t. t.bagent,0,0,0,2,0,2
t. t.benson,1,0,1,1,0,1
t. t.bigsby,7,0,7,9,0,9
t. t.boyd,0,0,0,0,17,17
t. t.brady,0,0,0,7,0,7
t. t.bridgewater,0,0,0,7,0,7
t. t.burks,0,0,0,0,1,1
t. t.burton,0,0,0,2,3,5
t. t.chandler,0,0,0,3,0,3
t. t.coleman,0,0,0,1,1,2
t. t.conklin,0,4,4,0,11,11
t. t.decker,0,0,0,0,1,1
t. t.dell,0,3,3,0,4,4
t. t.devito,0,0,0,1,0,1
t. t.doyle,0,0,0,0,1,1
t. t.eifert,0,0,0,0,2,2
t. t.etienne,2,0,2,19,1,20
t. t.franklin,0,3,3,0,3,3
t. t.fulgham,0,0,0,0,4,4
t. t.fumagalli,0,0,0,0,1,1
t. t.goodson,1,1,2,1,1,2
t. t.gurley,0,0,0,9,0,9
t. t.heinicke,0,0,0,4,0,4
t. t.higbee,0,3,3,0,18,18
t. t.higgins,0,10,10,0,37,37
t. t.hill,6,6,12,33,59,92
t. t.hilton,0,0,0,0,8,8
t. t.hockenson,0,1,1,0,22,22
t. t.homer,0,0,0,1,2,3
t. t.hudson,0,1,1,0,2,2
t. t.huntley,2,0,2,5,0,5
t. t.irwin,0,0,0,0,5,5
t. t.jackson,0,0,0,0,1,1
t. t.johnson,0,2,2,4,10,14
t. t.jones,1,0,1,3,0,3
t. t.kelce,0,4,4,1,54,55
t. t.kraft,0,7,7,0,10,10
t. t.kroft,0,0,0,0,4,4
t. t.lance,0,0,0,1,0,1
t. t.lawrence,3,0,3,14,0,14
t. t.lockett,0,2,2,0,34,34
t. t.mabry,0,0,0,0,1,1
t. t.marshall,0,0,0,0,1,1
t. t.martin,0,1,1,0,1,1
t. t.mcbride,1,2,3,1,6,7
t. t.mclaurin,0,16,16,0,34,34
t. t.montgomery,0,0,0,0,1,1
t. t.palmer,0,1,1,0,5,5
t. t.patrick,0,3,3,0,14,14
t. t.pollard,5,0,5,27,4,31
t. t.quitoriano,0,0,0,0,2,2
t. t.scott,0,1,1,0,1,1
t. t.sermon,2,0,2,3,0,3
t. t.shavers,0,1,1,0,1,1
t. t.sherfield,0,1,1,0,5,5
t. t.siemian,0,0,0,1,0,1
t. t.smith,0,0,0,0,10,10
t. t.spears,4,1,5,6,2,8
t. t.steele,0,0,0,0,1,1
t. t.sweeney,0,0,0,0,1,1
t. t.tagovailoa,0,0,0,6,0,6
t. t.taylor,0,0,0,2,0,2
t. t.thornton,0,0,0,1,2,3
t. t.tracy,5,1,6,5,1,6
t. t.tremble,0,2,2,1,9,10
t. t.tucker,1,3,4,1,5,6
t. t.wallace,0,1,1,0,1,1
t. t.williams,0,0,0,1,0,1
t. t.yeldon,0,0,0,0,1,1
t. ty.johnson,1,4,5,1,6,7
t. ty.taylor,0,0,0,1,0,1
t.allgeier,3,0,3,10,2,12
t.atwell,0,0,0,1,5,6
t.austin,0,0,0,0,1,1
t.badie,0,0,0,0,1,1
t.bagent,0,0,0,2,0,2
t.benson,1,0,1,1,0,1
t.bigsby,7,0,7,9,0,9
t.boyd,0,0,0,0,17,17
t.brady,0,0,0,7,0,7
t.bridgewater,0,0,0,7,0,7
t.burks,0,0,0,0,1,1
t.burton,0,0,0,2,3,5
t.chandler,0,0,0,3,0,3
t.coleman,0,0,0,1,1,2
t.conklin,0,4,4,0,11,11
t.decker,0,0,0,0,1,1
t.dell,0,3,3,0,4,4
t.devito,0,0,0,1,0,1
t.doyle,0,0,0,0,1,1
t.eifert,0,0,0,0,2,2
t.etienne,2,0,2,19,1,20
t.franklin,0,3,3,0,3,3
t.fulgham,0,0,0,0,4,4
t.fumagalli,0,0,0,0,1,1
t.goodson,1,1,2,1,1,2
t.gurley,0,0,0,9,0,9
t.heinicke,0,0,0,4,0,4
t.higbee,0,3,3,0,18,18
t.higgins,0,10,10,0,37,37
t.hill,6,6,12,33,59,92
t.hilton,0,0,0,0,8,8
t.hockenson,0,1,1,0,22,22
t.homer,0,0,0,1,2,3
t.hudson,0,1,1,0,2,2
t.huntley,2,0,2,5,0,5
t.irwin,0,0,0,0,5,5
t.jackson,0,0,0,0,1,1
t.johnson,0,2,2,4,10,14
t.jones,1,0,1,3,0,3
t.kelce,0,4,4,1,54,55
t.kraft,0,7,7,0,10,10
t.kroft,0,0,0,0,4,4
t.lance,0,0,0,1,0,1
t.lawrence,3,0,3,14,0,14
t.lockett,0,2,2,0,34,34
t.mabry,0,0,0,0,1,1
t.marshall,0,0,0,0,1,1
t.martin,0,1,1,0,1,1
t.mcbride,1,2,3,1,6,7
t.mclaurin,0,16,16,0,34,34
t.montgomery,0,0,0,0,1,1
t.palmer,0,1,1,0,5,5
t.patrick,0,3,3,0,14,14
t.pollard,5,0,5,27,4,31
t.quitoriano,0,0,0,0,2,2
t.scott,0,1,1,0,1,1
t.sermon,2,0,2,3,0,3
t.shavers,0,1,1,0,1,1
t.sherfield,0,1,1,0,5,5
t.siemian,0,0,0,1,0,1
t.smith,0,0,0,0,10,10
t.spears,4,1,5,6,2,8
t.steele,0,0,0,0,1,1
t.sweeney,0,0,0,0,1,1
t.t.allgeier,3,0,3,10,2,12
t.t.atwell,0,0,0,1,5,6
t.t.austin,0,0,0,0,1,1
t.t.badie,0,0,0,0,1,1
t.t.bagent,0,0,0,2,0,2
t.t.benson,1,0,1,1,0,1
t.t.bigsby,7,0,7,9,0,9
t.t.boyd,0,0,0,0,17,17
t.t.brady,0,0,0,7,0,7
t.t.bridgewater,0,0,0,7,0,7
t.t.burks,0,0,0,0,1,1
t.t.burton,0,0,0,2,3,5
t.t.chandler,0,0,0,3,0,3
t.t.coleman,0,0,0,1,1,2
t.t.conklin,0,4,4,0,11,11
t.t.decker,0,0,0,0,1,1
t.t.dell,0,3,3,0,4,4
t.t.devito,0,0,0,1,0,1
t.t.doyle,0,0,0,0,1,1
t.t.eifert,0,0,0,0,2,2
t.t.etienne,2,0,2,19,1,20
t.t.franklin,0,3,3,0,3,3
t.t.fulgham,0,0,0,0,4,4
t.t.fumagalli,0,0,0,0,1,1
t.t.goodson,1,1,2,1,1,2
t.t.gurley,0,0,0,9,0,9
t.t.heinicke,0,0,0,4,0,4
t.t.higbee,0,3,3,0,18,18
t.t.higgins,0,10,10,0,37,37
t.t.hill,6,6,12,33,59,92
t.t.hilton,0,0,0,0,8,8
t.t.hockenson,0,1,1,0,22,22
t.t.homer,0,0,0,1,2,3
t.t.hudson,0,1,1,0,2,2
t.t.huntley,2,0,2,5,0,5
t.t.irwin,0,0,0,0,5,5
t.t.jackson,0,0,0,0,1,1
t.t.johnson,0,2,2,4,10,14
t.t.jones,1,0,1,3,0,3
t.t.kelce,0,4,4,1,54,55
t.t.kraft,0,7,7,0,10,10
t.t.kroft,0,0,0,0,4,4
t.t.lance,0,0,0,1,0,1
t.t.lawrence,3,0,3,14,0,14
t.t.lockett,0,2,2,0,34,34
t.t.mabry,0,0,0,0,1,1
t.t.marshall,0,0,0,0,1,1
t.t.martin,0,1,1,0,1,1
t.t.mcbride,1,2,3,1,6,7
t.t.mclaurin,0,16,16,0,34,34
t.t.montgomery,0,0,0,0,1,1
t.t.palmer,0,1,1,0,5,5
t.t.patrick,0,3,3,0,14,14
t.t.pollard,5,0,5,27,4,31
t.t.quitoriano,0,0,0,0,2,2
t.t.scott,0,1,1,0,1,1
t.t.sermon,2,0,2,3,0,3
t.t.shavers,0,1,1,0,1,1
t.t.sherfield,0,1,1,0,5,5
t.t.siemian,0,0,0,1,0,1
t.t.smith,0,0,0,0,10,10
t.t.spears,4,1,5,6,2,8
t.t.steele,0,0,0,0,1,1
t.t.sweeney,0,0,0,0,1,1
t.t.tagovailoa,0,0,0,6,0,6
t.t.taylor,0,0,0,2,0,2
t.t.thornton,0,0,0,1,2,3
t.t.tracy,5,1,6,5,1,6
t.t.tremble,0,2,2,1,9,10
t.t.tucker,1,3,4,1,5,6
t.t.wallace,0,1,1,0,1,1
t.t.williams,0,0,0,1,0,1
t.t.yeldon,0,0,0,0,1,1
t.tagovailoa,0,0,0,6,0,6
t.taylor,0,0,0,2,0,2
t.thornton,0,0,0,1,2,3
t.tracy,5,1,6,5,1,6
t.tremble,0,2,2,1,9,10
t.tucker,1,3,4,1,5,6
t.ty.johnson,1,4,5,1,6,7
t.ty.taylor,0,0,0,1,0,1
t.wallace,0,1,1,0,1,1
t.williams,0,0,0,1,0,1
t.yeldon,0,0,0,0,1,1
ty.johnson,1,4,5,1,6,7
ty.taylor,0,0,0,1,0,1
v. v.green,0,0,0,0,1,1
v. v.jefferson,0,3,3,0,14,14
v. v.jones,0,0,0,1,1,2
v. v.lowe,0,1,1,0,1,1
v.green,0,0,0,0,1,1
v.jefferson,0,3,3,0,14,14
v.jones,0,0,0,1,1,2
v.lowe,0,1,1,0,1,1
v.v.green,0,0,0,0,1,1
v.v.jefferson,0,3,3,0,14,14
v.v.jones,0,0,0,1,1,2
v.v.lowe,0,1,1,0,1,1
w. jr.,0,0,0,1,0,1
w. w.dissly,0,2,2,0,9,9
w. w.fuller,0,0,0,0,8,8
w. w.gallman,0,0,0,5,0,5
w. w.levis,0,0,0,1,0,1
w. w.morris,0,1,1,0,1,1
w. w.robinson,0,3,3,1,5,6
w. w.shipley,1,0,1,1,0,1
w. w.snead,0,0,0,0,3,3
w.dissly,0,2,2,0,9,9
w.fuller,0,0,0,0,8,8
w.gallman,0,0,0,5,0,5
w.gallman jr.,0,0,0,1,0,1
w.jr.,0,0,0,1,0,1
w.levis,0,0,0,1,0,1
w.morris,0,1,1,0,1,1
w.robinson,0,3,3,1,5,6
w.shipley,1,0,1,1,0,1
w.snead,0,0,0,0,3,3
w.w.dissly,0,2,2,0,9,9
w.w.fuller,0,0,0,0,8,8
w.w.gallman,0,0,0,5,0,5
w.w.levis,0,0,0,1,0,1
w.w.morris,0,1,1,0,1,1
w.w.robinson,0,3,3,1,5,6
w.w.shipley,1,0,1,1,0,1
w.w.snead,0,0,0,0,3,3
x. x.gipson,0,1,1,1,1,2
x. x.legette,0,4,4,0,4,4
x. x.worthy,3,9,12,3,9,12
x.gipson,0,1,1,1,1,2
x.legette,0,4,4,0,4,4
x.worthy,3,9,12,3,9,12
x.x.gipson,0,1,1,1,1,2
x.x.legette,0,4,4,0,4,4
x.x.worthy,3,9,12,3,9,12
z. z.charbonnet,8,1,9,9,1,10
z. z.ertz,0,8,8,0,19,19
z. z.flowers,0,4,4,1,10,11
z. z.horvath,0,0,0,0,2,2
z. z.jones,0,0,0,0,11,11
z. z.knight,0,0,0,1,0,1
z. z.moss,2,1,3,16,5,21
z. z.pascal,0,0,0,0,10,10
z. z.white,1,0,1,2,0,2
z. z.wilson,0,0,0,5,1,6
z.charbonnet,8,1,9,9,1,10
z.ertz,0,8,8,0,19,19
z.flowers,0,4,4,1,10,11
z.horvath,0,0,0,0,2,2
z.jones,0,0,0,0,11,11
z.knight,0,0,0,1,0,1
z.moss,2,1,3,16,5,21
z.pascal,0,0,0,0,10,10
z.white,1,0,1,2,0,2
z.wilson,0,0,0,5,1,6
z.z.charbonnet,8,1,9,9,1,10
z.z.ertz,0,8,8,0,19,19
z.z.flowers,0,4,4,1,10,11
z.z.horvath,0,0,0,0,2,2
z.z.jones,0,0,0,0,11,11
z.z.knight,0,0,0,1,0,1
z.z.moss,2,1,3,16,5,21
z.z.pascal,0,0,0,0,10,10
z.z.white,1,0,1,2,0,2
z.z.wilson,0,0,0,5,1,6
